miRNA_seq	mRNA_seq_extended	binding_energy
GUUUAAUUGGCUCUGGAAACCUCCUACCUCCGUUGAAAGGAGAGCCAGUU	ACCACCGUCUCCACCCUA	-16.70
ACAACCUCAAGGAGAGGCCGCUCUCCUUCGCCAAAGCCUCGUGGACUCCA	CGGCACUGACCUCUGACAAU	-20.10
AGCUGGAGGUGAAAGCUCAGCAUACCAUGUAUUUACUUUAAAAACAGAAA	UGUUUUAGUGAUCAGAAGGU	-9.20
GGGAUUUGCAGACAGGCCAGGAGAUAUGGUGGAUCCUUUUCAUACCUUAU	CAAGAGGGUUGCAUUUGGGU	-12.00
GGAAGGGAAGGAGUGUGGCUAUGAGAAUAUGAUUUAUGCCAUUUUCUGUU	GGGCCGGACACACCACGAGU	-15.10
AUGAAAUAGCUUCCAGGAGCUCCAGCUAUAAGCUUGGAAGUGUCUGUGUG	GAAUCGUCCAACAUAAUAUA	-16.10
UCUAAACGCCCAUGAUAGUAGCUUCAAACUGGAAAUAGCGAAAUAAAAUA	GCCCUCCCCUGACUCGGACU	-7.40
GAUAGGUCGGGGAAGAGGGGGCUUUGGAGGCCGAGGCCGAGGCCGUGGAC	UGGCUAAAGUCUACCACGAU	-20.30
CCCACCGCCUCCACCUCCACCUCCUCCUGGGCCACCGCCCCCGCCUGGCC	CUCCCUCUGGGUCCGAGCCU	-15.50
UGUUCCCUGGGGGUGGGGGCGCUUGCCCAGGAGAGGGACCAGGGGUGCGC	AUCACGUUGAUACGUUUUGA	-25.40
AUCUGUGAUCUAGGGGGUGUCAACGAGCUGGCAAACUAUGGGGAGUACUC	UUGGUCGAUUCUGUGACGGU	-13.40
GCUCAACAAACUGCUAGGCCGGGUGACCAUUGCUCAGGGCGGCGUCCUUC	UGUUCACGGAAGUGACGUCA	-17.90
GCGGGAGGUGUUGGAGGCCCUGGGUGAAGUCAUGGUCAGCCGGCCCCGAG	GCCCCGUCGAGUCAUGUCCU	-25.10
UUGGGAGGCCAAGGCGGACGGAUCACUUGAGGUUAGGAGUUUGAGACCAG	UUCGUCGUGUCAUUAUAACC	-16.20
ACGCUUGGGAGUCCUCAGCAGGGGGAUCAUUCACAGUGAGGACAGACACA	AGGUUGUCCCGGCGCAGAGG	-18.10
UAAAAGAAGUCUACCCAGAAGCUAGAAAGAAGGGCACUCACUUCAAUUUU	UCAUUUGUUGGGAGAGGGUC	-18.00
UCUGCCCGCCAUGCCGUUCCUGGAGCUGGACACGAAUUUGCCCGCCAACC	UCUCGGAGGUGGGUUGGGAG	-20.80
UAAUAAUUAUAAAUAAACCUGUUAAAUUUUUCUGGACAAUGCCAGCAUUU	UCUGUGUAAACCUCUCCCUG	-6.30
AUUCUGAAGCACUUGAAAGAUAUUAAAGUGAAGUUCUCAGAUGCUGGCCA	UUAACGGGUUCAGAGGCGGA	-13.20
CGGAAUAGAGGCACCAGCCCUGGUAACUGCAUCUUCUCCCCUUGCCACCC	GUCUCGUCUGCACCAAGAGU	-12.90
CUAGACGGGCUGAGCCAUGUGCAAUAAGAACAUAGAUCCUAAAGGAUCCU	AGGGGUGUCUGGGUCUCGGC	-24.30
UGUAGUUGAUCCUGGUGUGUGUAUUAUAUAAAGAGACCCCUCCCCUUAUU	ACAGAGGUGUCCCGAGAAAU	-8.60
CGUCGCCUUAGUCCUCCUGGCUGCCGCCGUCAGCUGUGCCGUCGCGCAGC	GGAUAGGACCUAAUGAACUU	-21.80
UAGUCGUGGCCGAGUGGUUAAGGCGAUGGACUAGAAAUCCAUUGGGGUCU	CGCCUGUGCUGUAAGGGCUA	-18.70
UGGCAAACUAGAGGGGAAGUGCCCAUUGUAAAAACACAUCCACAGACAGU	GUACACGUGUGUCGGCCCAC	-14.00
GCGCAAGAUAGAUUUGGAAUAGGAAUAAGCUCUAGUUCUUAACAACCGAC	CGUCUUCGUAAAGGCGUGUG	-15.30
UUUAGUGGUGGUGGUUUGUUUUGUUUCAUAUCAUAUCACAGUUUGCAUGG	CCGACGUUGUGUUCUGUGCU	-13.80
ACCAAGGAGAAGGCCCAGGGCUAUGGAUUUCUUCUGAGGAGCAGCAGAGU	GGAGGUGGUACGUUCCCUAC	-17.70
ACAAAAGUUCCCUCUCACUUUCAGUAAAAAUAAAUAAAACAGCAGCAGCA	UGGUAUCCCAUUUUGGUGAC	-5.90
UGGGGCCUAUGGAGAAAUUCUGGAAUAAAUUUUUGGAGAAUAAAUCCCCU	CCGUAAGUGGCGCACGGAAU	-15.20
UUCUCCCUUGCCUUUGACUCAUUGGACUAGUGCAGAGGCUUUAAGUAGUU	UCUACCUCGGUCCCGGGAUU	-16.60
GAAGGAUGGCCAUUCCUGGGGCUAGUGGUAUACCAGGAAAUUCUGUUCUA	GUGUCGGGGGCAGGGAGGGA	-24.50
AAAAGCAGGAUUUCGUUCAGCACUUCUCCCAGAUCGUUAGGGUGCUGACU	GGUGGAGGGCUCAGGAGUG	-19.90
UAACUGGACCACCCUGCAGAGACUCAACGCUGGCCAGUGGUUCCUGAAGA	GUAAUAAUGAGUGCCAUGCU	-13.50
UCGAUAUCCACAACCCAGCCACCAAUGAGGUCAUUGGUCGGGUCCCUCAG	GAGAAUGAGGGAGUCCGUGA	-25.10
CACAAUGACUGGUGAUGGGGGAGAAUACCUUAGGCCUGAGGACCUAAAAG	ACCGCGGACUUGUCCCUG	-20.40
CAAAAAUUUUGGUGGUCACAGGGAUUAUGGACCCAGAACAGAUGCUGAUU	CCCCCCGCUCCGUCCACACU	-12.70
CGACUUUCACGAUGGCUCGCCCAACCUUACUACCUUCUGUCGGCCCUGCU	ACUCAAGAUGGUAACGGUUU	-12.20
GGCUCCUCCUCUCCCCUUGCGGCCUUUCUAACGUUGGCCCUGCUCUUGUG	CCUCAAGAACCGUACCCUCC	-12.80
CAGAGCACCUCCGACUACCUUGUGGUCUACCUGCGGCUGCUCACCUCGGG	UCAAGAAGUUGACCGUCGAA	-18.00
AGUUCCAGAAGACCCAAAGGAGAGUACUGGUUUGUGUUUGGUGCUUGGCC	GGAAGAUGUUUAAGUGGGUA	-16.80
UGCCAACAUGGCCACGUUGCCCAGCUGCCCAGCCCCCAGCUCCAGCCCGG	UUUCCGUCGUCCAGCAUAUC	-15.40
CCACAACGAGAACAUGAGGCAAGGCCGGGACAAGUACAAGACGCUGCGGC	CCGACGUUGUGUUCUGUGCU	-20.30
ACUACACAGGCCCUGGGGAUCAGACUGUGAAUCCUCAAAAUGGUUUUGUG	AGGAGAGUUGGGUCGAAAA	-18.40
CUCACUGGAACUCUCUGGUGCCAGUACGACUUCAGGUGGUUCCUAAAAAA	UUUUCGUUGACUCCAAGAAC	-17.40
GAGAGAAAAGAAGAUCUACAGGAGUUUCAUUUUGGACACAAGAUAGUGAU	UCUGGCUCUGUUCACGUUAC	-13.90
AAUCAGCCUUUCUCCUCUUCUCUUCUUGGGACAGGAAUAACUGCUGAGCA	GGUGUGUUGGAUGAUGGAGU	-19.70
GCAAACACUAACUGGGGGAUUUUAUUUAUAAGGGCUCUAGAAAAAACGAG	CACCUCGGGACUCUUGGCCU	-12.80
GAGCUACCCGCAGUGCUGAGCCAGCCGUGCAAAAGGAAAUCUUCAGGAGG	GUCUACCUAUGGCACGUUAA	-17.60
CCUUAUCCGCUACCUCCAAAGUGACAACAAUACUGCCCUGUGCAAAGUCC	CAGUGACUUCCCAAAACUCA	-6.70
UGUGGGGACUCAACACUGACCCAGAUCACAGCUGGGCUGGACCCAGUGGG	GUUGAAUCAUUACACGUUAU	-17.00
AAGAGGAUGAUCCAGUGCCUGAGAUCCGUCGAGAUCACUUUGAAGAAGCC	UGUGUUAUUUACAAACGACU	-12.40
UCUAAGGAGCCAGAGGGAGCAUGGUUGCAAGACCCCGGCAUCCACGUGGG	GUAGUCGUGACACUAUUGAC	-17.70
ACCCAGCACAAAGGAAGAGACUCCAGCAGCAGAUGCAGCAGCAUGUUCAG	GUUCGGGUCUGGCGUUUUUC	-17.80
UUCCUGGCCGCCAGAAGAUCCACAUCUCAAAGAAGUGGGGCUUCACCAAG	GGUAUGUUGGAUGAUGGAGU	-19.90
UCCGCCCUCUUUUGCCAGCCCAGCCCCUCCAUGCACAUUUGGACGCUGUC	GUUGUUGUACUUUGAUGGAU	-14.00
CCCUCCCCCAGCCCGAGGCCCACGGAGGUUCCUCGGGGGACAGUCUCAGU	GGCCGCGGCUCCCGGGCUA	-29.60
UAGGCCGGGGGCUGGCAGAGGGUAUAAUAGCAUUGGCAGAGGAGCUGGGU	CGUUACGUUGUCGUUACGUG	-17.80
GUAUUGUUGCUCCUACCUUCAAAUAUGACACCUGAAAUAAUAAGUCUGUU	UGAGGCUAUACGUUACCCAU	-7.90
AAUAUGGCUAUUUUUAAUGGUGACAAUUAUGACUUUUAGUCACUAUUAAA	UGAGGGUCCCACAUUGAGAU	-14.10
GGCCAGAGGAGGACUCAGGGAGCAGUGAGGAGGAGUCAGACAGUGAGGAG	GGCCGCGGCUCCCGGGCUA	-19.50
AGCCACCAGGGCCCCAGGCUCGUUUUCCUUUAUAGCGAAGCAAAAAACAC	UAGGGUAGGGGUCCUUGGGG	-28.10
GAGGAGAGGCCCAUGUAUCUGCACGAGCACUUAGCUUGUUCAGAUCUCUG	ACCCACACACGUACUCGCAC	-18.40
UGCACCGAGCUCCGGGGCCCCACACCCGCUACGGUGGCCCUGCGCCCGUU	GAUAUGUUGGAGGAUGGAGU	-24.10
GUCCUGACGCCCUCUCCAUGCCCCACAGUAAUGUGGCUUCUUUCAUGGGU	CGACAGUUAAGUAUCCAGUC	-17.70
GUCCGCUGUGCCCGGGCCUGCACCAUGAGCGUCCCGGCCUUCAUCGACAU	GUGGGUCCAUCGUUCCUAAU	-18.30
CAGGAGAGCACCCCUCCACCCCAUUUGCUCGCAGUAUCCUAGAAUCUUUG	CCUACGUUUGGACGUUUUGA	-11.30
GCAGGUGGCCCCAGCUGGGUUUCCCAGGUCAGGAAUGUGGGCCCCAGGCA	CCUCUCUGUUCCCCUUCUCC	-22.70
GAGACAUUGAAGGUACAGGAGCUAAAAGUCAGUAUUUUGGCUCUUGCCAC	GUUGUUAUAGGACCACGACU	-18.10
AAAUCCUGUUCAGAGGAGCUUCAGCCAAUGAAGAGGCUAUAUCCCGGCUU	UUCCUAAAAAUCCCCGUAAU	-15.30
GUCUAUGGAUUUUAUGAUGAGUGCCAAACCAAAUAUGGAAAUGCUAAUGC	UGUUGGGAUCACCGCGGUAA	-14.30
CCCAACAAAGAAGAUGAUACCCAGUGGCUGACCUACUGGGUAGUGUAUGG	GGGUCAUCGGUCUACAUCGA	-24.50
CCCUGUCACCCAGAGCAACCCCAUUUGCCAGCAGCAGAUAGUACUGAAUC	CCUCUGUGCACGUGACAUCU	-13.50
CAGGAAAACGAUGAAGAGGCAGUGCAAGUCAAAGAGCAGAGCAUCCUGGA	CACCUCGGGACUCUUGGCCU	-13.90
UGGGACCUGGCUGCUGUGAUUGCACAUGAUUUCCUGGCCUUCAUUCUGCA	GUCCUCGAGUGUUAGAUCAC	-16.10
GGACAAGCCCAGAUUCCAAAACUUAUGUCAAAUAUGAGGCCCCAGGAUUC	UAGAUGUAACAUACGGUCCA	-13.20
CCCAGAGCACAGAAGGCUGGGAUUUUCUUUAUAGUAAAUAUCAGUUUUCU	GUUUGGUGUCACACGACGAC	-19.30
UACACAUCUCCCAAGAGGCUGACUAUUAAUGGAGGUUCAAAUGGAGGCCU	UUUAAGCCUAGAUGUCCCAU	-11.40
UUAAAUGUUCCGGUAAUGUGAUGCCUCAGGUCUGCCUUUUUUUCUGGAGA	GGUGUGUUGGAUGAUGGAGU	-16.70
GGAAGGCAAAGAAAGAAACUGAGCAUAGUAAACACAGCAUUUUUUUGUAG	UCUGCCCUCCUCUCCUCACU	-10.10
AAUUCGGGAAAAACUAGCCAAAAUGUACAAGACCACACCGGAUGUCAUCU	GAGUUCCUCGAAGUCAGAUC	-8.20
AGAAAGUGGGAAUGGAGGGAGGCCAGGAAGCUGUGGUGGUGGAGCUUCAG	GAAGACUGGGAUUCAGGUCA	-17.50
UUUCAGCAAGGUUAUGUGCUGCUCUCCUGAGCAACAUCUCUGACUGUGAU	GACUCACAUCCUACAAAUGU	-15.30
UACAACAGGCUGGGAGAGUUUACUGUGGGUUGUCAAUCAAUUGUUGCCAC	GGUUAUAAAGACACGACGAU	-12.90
AUCAGUUGUUUCAAGUAAUGGCCCAGGUAAUCGGGCUGGAUCAUCAAGUA	UACCACGAACUGCCUUGGUA	-13.60
GCCGAGGCUGGGGCUGGGUCAGCAACCGAAUUCCAGUUUAGAGGCGGAUU	CGUAUCCUACUGUUUCCCUU	-22.20
CAUCCAGAGGGAACCUGUGUGUGCUGCCCUCAACAGCGCCAUUUUAGAGU	CGCCUGUGCUGUAAGGGCUA	-15.60
GUGGCUCUGCGCGAGAUCCGCCGCUACCAAAAGUCGACCGAGUUGCUGAU	CAUUAGGGACCGUUACACUA	-15.30
CUUCUCGGAGACGGUGCGCAUCAUCAACCGCAAGGUGAAGCCGCGGGAGC	UCUGGCUCUGUUCACGUUAC	-23.90
UGGAGGGCACACGGCACGGCCACCUCAUCGCCGCCCAAAUGCUGGACGUG	CCGCCGUCCGUGUCCUGACC	-26.40
GAAUGCCAGCUACAACUUAGAUCCCUACAUCCAGGAAUUUGGGAUCAAAG	CGUCGUCGCCUCCCCCGUCU	-15.70
ACUCCGGGGGUCUGGGUGGGGGGCUCAAACGCAGGGCUCUGGGACGCAGG	AGUCUUAGUGUGGACCCCCU	-29.90
UAAAGCUCUACUACCUCUCUUUGCGGUGCUAUGUGGAAAUGACCAUGUUA	UGACGUGAUCUACGUGGAAU	-13.10
CAGUUCACUGCAACCUCUGCCUCCUAAGUUCAGGCGAUUCUCCUGCCUCA	CACUCGUGGGCCGGGGACGC	-21.50
ACUUGGAGGGGCCCAGGGACAUUCUUGUGCCUUCGGAGGACCUCACCCCU	AGUGGUUAGUCGAUUCGAGA	-22.10
GCCAACCAGCGGAAAUGUGAGCGUGUACUGCUGGCCCUAUUCUGUCACGA	CAGAGUGAAACAACGGGUCU	-17.30
CAUCGGGGUGGAAGGGUCUGAGCAGAAGGUGGACCCAGCCCUCUUUCCAC	UCAUUUGUUGGGAGAGGGUC	-27.10
GUCAGGAUCCCGCUGCACAAGUUCACGUCCAUCCGCCGGACCAUGUCGGA	UGACGUGAUCUACGUGGAAU	-19.20
GAUGGAAAAUCUCAAAUGGGAGGUGGAUCAGAAAGAAAGAGAAAUCCAGU	UGUUUAGAGGUCUGGUGGGU	-12.90
CCUGGGACCCCCAGGCGUGGAGGACAGUCAAGCCGUGGAGGCCGUGGAGG	GGGUACCUUAAGUCAAGAGU	-26.90
CAGGUUGAAGUCUCUUCCCUUUCUACCCAGUACUCGAGCCCAGGGCUAGA	CCUUCCCGUCUCUCCCGGUC	-19.80
GAGGCAGCUGUGGGCAACUGUGCAGAGCAUAUGCGCCGCUUCCUGCAGUG	GGUGGAGGGCUCAGGAGUG	-30.30
GAACGGGAACCGGAGCCUGGAGACUCCCCAGCCGGCCGCCAGCCUCCCUG	UGACUAAAGUUUACCACGAU	-15.00
AUCCCCCAGCCUGGGUCCGCCCAGAUAACGAGGCCCCACCCAAGGUGCCU	ACUGAGAUAGGAUACAGAAA	-19.20
UUCCCUCCCAUGCCUAGCUGGAUUGCAGAGUUAAGUUUAUGAUUAUGAAA	UUUCAAGACAUCACGUGACU	-9.10
CCAGAACCAGGUCUCAGGGGGCACUAAAGGCGGUCGGAGGUAAUCCCCAC	GUGGCUGUCGUUACUUACAA	-14.50
AAAAAGCAGGCGGAGAGUGCUAGUGAGGCGGCCAAGAAGUACAUGGAGGA	CCAGGAUGUGAGUUCCGUAC	-13.60
UCCGCCACCACCGCCGCCUCCUCUUCCUUGGCCACCCCAGAACUGGGCAG	AGGAGAGUUGGGUCGAAAA	-19.20
UGUGGGGGAAGUAGUCCGGGCCAUGGAUAAGAAGAAAGUGUUGGUCAAGG	CCGACGUUGUGUUCUGUGCU	-11.90
AAAACACAUAGCCUACCCCUUCCUUGUACUAUCCCUAUGAGGCAUAAUUA	ACAUAUACGGGUACCUGACG	-14.30
UAAAUAAUGGGUAGCCUGGGCUCUGUGUUACUUUCUUGUAUUUUUAUCCA	CAGAGCGAGAGACGGGGAGU	-17.40
UCAAGGGACAGCUGCAGUAGCUCUAGCAGGUCUUCUUGCAGCACAAAAAG	UUUCGGUCCCAGACAUAUCU	-17.10
CAUGUGCCAUGGUGGUUUGCUGCACCUAUCAAUCCAUCAUCUAGAUUUUA	CAUCGCCUUCGCCAUUGACC	-14.30
GAUAGUGUCCAUCACACCUCAGGGGAUAAGAGCACUGAUUAUGCUAAUUU	UUUCAAGACACUACGUGACU	-16.70
CAGUGGGAAGGCCAAGGCUAAGGCAGUAUCUCGCUCACAGAGAGCUGGGC	UCCGGCCCUGUUCACGUUAU	-26.40
CAGAUGCAGAGAGCCAUUUUGUGAAUGGAUUGGAUUAUUUAAUAACAUUA	UGACGUCCGGGAUCUCCUGU	-15.00
AGUCUGCCUUCUCCUACCUCAGCACCGCCCGGGACCCCCACACAGCAGCC	UUGUAGUCAGACUAUUCGAU	-10.70
GGCAGACCGGGUGGAGGCAGUGUGCACACUGACCGGGCAGGUGGUGCUGC	UGGUUAGCGGCAGGGGCGGC	-23.80
GCAACAGGGUCCGGGACAGGGAUGUCUACCUGGUAAUAGAGGACUUGAAG	CGUCUUCGUAAAGGCGUGUG	-18.10
UUGGAAAACUUGUGCCCUUGUAUAGUGUCCCCAUGGGCUCCCACUGCAGC	CUCUCCUCACGUUGAUCGUU	-14.70
GCCCCAGCGGGUGCGAGGGGUGUCCUCUGAGAGCUCUGGGGACCGGGAGA	UGUGGUCCUCUUUAGCCAGU	-34.30
UGGUCCUGCACGAUGUGUAGCACUUUGUAGUUUAGGUAUUUGGAUUUGUG	GUGGGUCUAGACGCCGGAUU	-20.10
AUCACCCUUGAGGUCGAGCCCAGUGACACCAUCGAGAACGUCAAAGCAAA	AGUGGUUAGUCGAUUCGAGA	-16.80
ACAGGAACCCUGGAUUGCUUGUUACAGACAUGGAAGAAUGAAGGGUUUUU	CUCCGGGGACGGCGGGGC	-18.60
UGUACGAGGGCGAGAGGGCCAUGACGAAAGACAACAAUCUGUUGGGGCGC	AUUGUUAGCUUUCGGUGCCA	-20.80
UGUUUGGUGAUUCUGAGCCUGAACUUGAUGAAGAAUCAGAAGAUGAAGUA	GUUUUCAUUAACACCAAAAA	-11.20
CAUUGGGACCUGGGGGACCUCAGAGCAGAGUGCCACAUUACAGGGUGAUC	CUUCCUCGUGAAUCCCGUCA	-17.40
GUGGCCGGAUGUGGGAUCUGGAGAAUAUGAUGUUGGAGUAGUGGCUUCGU	CGGGAAAAUUGUAACGUGAC	-13.90
UACAACACACCUACUAUCUCUUGAUGCCCUAUUGACAGUGAUUGACAGCA	CAUUAGGGACCGUUACACUA	-11.20
UAACCUCCUCGGACUCCUGCCUCACUCAUUUACACCAACCACCCAACUAU	GCGUGCUUGCGGACAGGCCC	-15.90
GUGAGGAGGGGGACCCUGAUGAUAUCAACAGCACUGCUAAGGUGGUGGUG	GUUAGUGUCUAUCGUGGGGA	-21.20
GCUAAACCCCACGGAGCCUGACCACGCGAUCCAGUGGGAUAAAUCGAUGU	UCAACCGUUCAGAUCUUGGU	-15.10
CCAACUUCCGGCGGGUGCCCCGCAUGCCCAUCUACGGCACGGCCCAGCCC	UACCACCGUCACCACCCUA	-18.90
GCCACUGUCUGAACCAUCCCUGUACAUCUGCACCUUCUUGUGCAAGGAAG	UUAGGAACGGGUCCACGUAA	-16.60
ACGACAUCCAGCCACCUCCUCAGUCUCUGCCAUCCACAGGAGGAAGCAGC	ACAGAGGUGUCCCGAGAAAU	-18.10
AAUAGUGGAUGAUCGUGGAAGAUCUACAGGGAAAGGCAUUGUUGAAUUUG	UCGUUCAUGGGUGUCACGCC	-14.80
CCUCUCGCUCCCCCACCACCAGGAGCCCCACCUUCACCAGCCCCAGCCCG	UUUCAAGACACUACGUGACU	-8.70
CCCAGUCCCUGCCACAGACCGUCUCAGACACGCACAGUGGGCCUGCUGCA	UGACGUCCGGGAUCUCCUGU	-17.30
UUCACUGGAUGUUGCUGAAGAAGAAAUCAUAGACGAUGAUGAUGAUGACA	GGAUACCUUAAGUCAAGAGU	-6.80
UAUGGAGGGAUGAUCUAUACUGGGCUGAAGAACUUUGAAAGAGCUCUCUA	AUUGUUAGCUUUCGGUGCCA	-11.50
AGUAAGCCUCACCUUUGCCUUCCAACUGCCAGAACAUGGAUUCCACUGAA	CUUUAGGGACCGUUACACUA	-9.50
CCAGCUGGGCACAGGGCAGGAUGAGGACGCCUGGAGCCCUGUGGAGAUGA	UUGUUCAUUAGUUCUUAUCC	-20.40
CCUGCGUGCCCCGCCACUGCCCAUGGCCAGGAGGCCCCAGGGAACGGACA	AGCCCUACCGCGGGCAAGUG	-26.40
UGCUGCAGAUUCUCUCAGAUGACCGGAAGCUGAAGAUCCCUGAAAACGCC	GGGGGUGGUGGUGCGGGC	-19.20
CGGAGGGAGAGCUCAGGGUGGCUUAAUCCAGAGGCCCUGUCAUGGCCCGC	GAGUUCCUCGAAGUCAGAUC	-21.90
AGAAAUCAAGGGAUUAGUGCAACCAGUAGAAAGCAUUGAAAUGACUGUCA	CAGAGUGAAACAACGGGUCU	-9.30
CUACUGCUGGAAGUGGGCUGCCAACAGGCAGUACCUCUAAUAUAUUUGCU	AGGUUGUCCCGGCGCAGAGG	-24.60
CUGGCGGACCUGGGCCUGGACUCGCUCAUGAGCGUGGAGGUGCGCCAGAC	CAGUGACUUCCCAAAACUCA	-23.00
GGGAAUGGGCGGAGCACGUGGGCUGCUUAACUGCUGUAUAGGACAAGCCC	CCUCUGUGCACGUGACAUCU	-25.40
UCUUCUCAGAUGGGAUGACUGCGGGUCAGUGUACAGGAAGAGGCAGGCAC	GAAUCGUCCAACAUAAUAUA	-19.00
UCCGAGGGCAAGAUGGUCUCGGACAUCAACAAUGGCUGGCAGCACUUGGA	GUGGCUGUUGUUACUUACAA	-26.90
GCUCUGCUUCCUGCCUCUGCUUCUGCCGUAUCCCUAAUAAAAUGUGGAGG	UACCACGAACUGCCUUGGUA	-12.20
ACGGAGGAGGAGGAUCCUAAAGAAGAGCCUAUAAAGGAGAUAAAGGAGGA	GUUAUGUUGAAUGAUGGAGU	-9.10
UCAGGUACCAGCUUAAAGAGCACUAGGGAUGGGGAACGAAUGCCAAAUCA	UUUAAGCCAAGAUGUCCCAU	-11.70
AUGAUUGACAUGCCCGUGGAAAGGAUGCAUCCCCAUCUGUCCAAAGGCUA	CCGUCGCGAGUCGGGCGCGA	-22.50
UCUCUUCUCCCUGCCUAUUAAGGAAUCAGAGAUCAUUGAUUUCUUCCUGG	CGUUACGUUGUCGUUACGUG	-15.00
GGUCUGUACCUGGUUGGUCCUUCGUCUUUGCAUGUAAGCUCUUUGAGAGG	AGGUAAGGGGUCCUGAGGUG	-13.40
UUAUAAUACCAAGAAUGUGCUGCGUAUCUUGUCUCAAUAAGUUUUAAGUA	CCCUCGCCCCCGGGACGGAA	-11.60
CGGGCUGGACUCAGGCUUCUCAGGAAAUCUGGCAUUUUUUAAAGUUUGCG	AUGUCGAUCUAUUGGUUUCU	-15.90
CUCAGAGGAGGGUUUGUCGGGCAAAUUCAGGUGGAUGAAGUAUGUGUGUG	AGCCUCACAGAGUCUUGAAA	-15.10
GGACCCUGAGUUAGGCCUGAAGUCUGUGCAGAAGCUACUGGAUGCUGUGG	CCCGCCCUGCUCGUUCGUGU	-16.70
CCAACAGUCCUACCUCAGAUUCUGCAUCUGUACAGAGAGCAGACACUAGC	CAUUAGGGACCGUUACACUA	-15.90
AUGCUGACCACCAACGUGCCGGAAAUCCAGAGAACCAACUUAGCAAGCAC	UCCCUUGUGUCCCGACCACU	-8.50
UCUCAGUAGUUGGCAUGCAGCUUUUUGGCCGUAGCUUCAAUUCCCAAAAG	UACAUCAGGUUUCCGUGUAU	-16.00
CGCUCCUAUUCCUGCUCUGCCCCUGAAGCUCCACCCCCACUGGGUGCCCC	CUUCCGUUAUCUAACAUAUC	-9.70
UCAUCACUUCAGCUCCUGAUUGGUCCCAGGCCAAGCUGAAUAGCCCUUAG	CUCGAGGACCUCCUGUCCCU	-21.60
ACAAGCAGAUCUACUACUCGGACAAGUACUUCGACGAACACUACGAGUAC	GCAUAGGCGUGUUUCGGAGA	-11.00
AUCUACAAGGCCCAGGCACAGACUGACCGAGAGAGCCUGCGGAACCUGCG	CGUUUGGGACGUACACCCUC	-20.50
UAUUGGAAAGCCAUUAAUCAUUGAAGAACUUAAGCAGGUGGGGCAUUUAA	UGGUACCGACAUCUGACAAU	-8.90
CUGCUCACUCUCCUCACCCAGCUAACCCUGGCAGCCGGCAGUACCCCUGC	GGGUAAGGUGUUCGGGACUA	-18.10
UUCCCUGCCUUCUGUCUCCUCUGCACCUAUCACUAGCGGGCAAGCUCCCA	UCUCGGAGGUGGGUUGGGAG	-21.30
GCAGUAAGGCCUCCUCCUCGUCGGCCUCUUCGGCAGGGGCUCUGGAGUCC	UGUGGGUGCGCUCGGCCUUU	-21.40
GGUUCUAGAGCCUUCUUUCCGCCAGGCCUUUCCCAAUACCAACCGCUGGU	AGUGGGUCCCUGUUUCCUAA	-13.60
CUGAAGAUAGAUCGCCAUCAUGAACGACACCGUAACUAUCCGCACUAGAA	ACCGUCUGACACUAAACAAC	-6.50
AUCGGUGCCCCCGAUAUGGCGUUUCCCCGCAUAAACAACAUAAGCUUCUG	UCAACCGUUCAGAUCUUGGU	-11.90
CGGAGCUCGGGCCGGGGGCCACCAUCGAGGCGGGGGCCGCGCGAGGGCCG	UACCGGGAAGCCAUUAAGUG	-28.00
AUGAUUACAGGGACAUCUCAGGCUGACUGUGCUGUCCUGAUUGUUGCUGC	CCCCCGCCGUGUCCCCGAGU	-18.60
UGGUUCGCUAUGGCCCGUACUAAGCAGACUGCUCGCAAGUCGACCGGCGG	UGCCCUCACUAGCACAGUAA	-12.80
AUCUACGCCAAGGACCGCACAGACCGGAUCCGCACAUGUGCCAUCCUCUG	UCUCGGAGGUGGGUUGGGAG	-22.60
ACAACUGCACGAGCGCGCACCCACCGCGCCGGAGCCUUGCCCCGAUCCGC	GUUAGUGUCUAUCGUGGGGA	-23.20
CCCCGACCACCACCUGGAAUGCCUCAUCCUGGACCUCCUCCAAUGGGCAU	CAAAACGUAUCUAAACGUGU	-14.70
AAGGCUGGAGGGCAGGAGGAGGGCCUGGGUUUGGGUUCUUUCCUCCCAGC	UUAACGGGUUCAGAGGCGGA	-24.80
GUUUUCUGUGCACUGUAGCCUUAGUGUCACCUUUCUUCUUGUGUCUCCUU	GGACGUGCUUGUCGUGAAAC	-12.80
GCCGUCCGGGAGAAGGUGGGUGACAUCACCAUCCUGGUGAACAAUGCCGC	UGCUACUGUUGCUACUGCAU	-20.50
GCCAAGAGCAUCCCAGGCUUCUCAUCGCUGUCGCUGUCUGACCAGAUGUC	GGACGUGACAUUCGUGAAAC	-15.20
UGCAAUGUCACCUCCCACGGCAUCGAUGGCUGCGAUCUGCUCUGCUGUGG	CCGUCGCGAGUCGGGCGCGA	-23.70
UUGAAUCCUCCUCUUCCACCACCCCCUCUCCUGGCUGCCACUGUCCUUGC	GAGUCGCCGGCAAAGGGGUU	-14.90
GAGCAGUUGGUUCAAUCUCUGGUAAUCUAUGCCAGCAAUUAUGACAAUGU	GGAGGUGGUACGUUCCCUAC	-14.50
AAGGAUCAAACCAAGGCCCAGGCUGCAGCCCCAGCUUCAGUUCCAGCUCA	CUACGUGACACCUUUGUAAC	-13.30
GGUCUCUUUCCCCCUUCCUCCUCCUCCUCCUCCACCCCCCCUUCCUCCUC	ACCGUCUGACACUAAACAAC	-3.40
UGGUCGGAAGCGGAAGGCAGAGGAAGAUGCGGCACUGCAAGCUAAGAAAA	CCUUGGCCGUAAACAAGACU	-15.30
UUAAAUAGCUGGGACUACAGGCACGUGCUGCUACACCCUGCUAUUGUCUG	GACCAUGUUCCCAACCCUCU	-15.30
AGCCCCGCGGUGCUGGCAUUACAGACAUCUUUAGUUUUUUCCAGAGAUUU	ACAUUUGUAGGCUGACUUUC	-12.20
UUGACAAUCCCAAAGGCCGGGUCCCACACCUGGCCCUGCCUGCCGGGUCC	AUGUCAGUUGCCAGUCACCA	-21.20
CCAAAAGGUGGAACCAGCAGGUAGAUCUAGGUUCACCCCGGAGCUCCAGC	GUUCUGGGGCCUCUAGGGUC	-30.10
AGAUCCGCCAGAUGUCCGGGGCCCAGAUCAAAAUUGCCAACCCAGUGGAA	UUCCGGUGUAGGUCGUGGCA	-22.60
ACAGUGCUAGAUGCCAUUGAUCAGAUGUGGCUGCCAGUGGUGAGGACUUG	UCGACGGGGACUUUCAGGGA	-23.90
UUUCACUUAAUUCUUUACAAGGGAUAUCAAAGCCAUAAUGGACUUCAUUA	GGUCCGGACGUACGGGAGUG	-13.90
CCGCAGACACUAGGCAUUUGGAUUACUAUUUUUCUUAAUGGCUAUUUAAU	UGUUUUAGUGAUCAGAAGGU	-15.00
CAACCAAGGCAAUGUCUUACUACCUCAGCUCAGAAAACCACCUGGACCCA	CUCCCUCUGGGUCCGAGCCU	-13.90
GGAGACACCAGCCGGGGCCUGGGCACGAGCCACCCACCUGGUAGAACUGG	CACUCGUGGGCCGGGGACGC	-27.80
CCCAGGGGGACCCUGAGCCAUUGCCCCCCGUGCCCAAGCCCCGGACAGUC	AGGUCAGUUCCUACAAAUGU	-16.90
GCAGGGAUUGUGGCUUGAUGUCCAUGCGCUUGGGGAGCUGCAGCGCCAAG	GAGGGUUCUUGGAGUGGACA	-21.70
AGGAACCCAGUGGCCAGGGAGCGUGGCACUUACCUUUGUCCCUUGCUUCA	UUUCGCACCCCCUUUGUGCC	-17.50
CCUGUCGGGAACCUGAUGUCCUCAUCUUGGACGAGCCAACCAAUAACCUG	GCUGGCUGCGGUGCGGCUCA	-17.70
UGACACCCAACAGCAACAGGCCGAGAACAGUGCAGUACCCACUGCUGACA	GAUAUUCGUUAUAACGUGAU	-11.90
CCUCUUCCUCCUCCUCUUCCAGCAGUGAUUCUGACUGAAUACAGGCCCUG	CGAAAAACCCCAUUCCCGAA	-10.00
UCAGGUACCAGCUUAAAGAGCACUAGGGAUGGGGAACGAAUGCCAAAUCA	UGAAAAACCCCAUUCCCGAA	-13.60
UGUCAUUACUUCCUGUAGCUGCAGUACAGAAUUGUUACAGACCUGGAUUA	CUUCCUCGUGAAUCCCGUCA	-11.20
CUGAUCAAGCGCAACUCCACCAUCCCCACCAAGCAGACGCAGAUCUUCAC	AAUGUUAUGUUAGACUAUUC	-6.40
UGAAAAUGCAUUACUUUUGCACAUUGAUAUUAACUGUUGUCCAACAAAUA	CCCCCGCCGUGUCCCCGAGU	-8.10
ACAUGAGGCAAGGCCGGGACAAGUACAAGACGCUGCGGCAGAUCCGGCAG	GGCCAUCAGGGUCCGGUCA	-19.80
AAGGUGUACUGGAUGUGCCGGGACCAGGCUCGGCUGGGCUGCCGCAGCCG	AGGUUGUCCCGGCGCAGAGG	-28.00
GACAGAAGGAGCAUCAGAAGGAGCAUCGGCGGCACAGGCGGGCCUGUAAG	CAGACCCUCUGUCUCCUUGU	-24.50
UGUUCCUGCUGCCAGUUCUUUCCUCUUUAGGCGUGGUUGAGAAAAAGCAG	GGGUUAAUUACAGACAACUA	-11.90
AAUGGGCCGACGGACGGAGCUGACCACCGAGAGCCCACUGUGGGUCGGCG	UACCCCACUACACUCGGG	-24.70
GGGUAGUUGCCAGGGUCCUGCAGUUAUACACAAAGUCCUUAGGAUAAGAC	CGGGACCUGAUCCUCAGUCG	-16.00
AGUCCCUUUCCUCUGGGGCAGUGGCAACGACCACGUCCUCUGCUGGUGAU	CGCAUGGUUUUCAUUAUUAC	-18.60
UUCUACCACCAGCCCUGGGCCCAGGAAGCAGUAGGCAGGCACAUCUUUGC	GCUUCGAGGUUCCAAGGAGG	-13.70
AACCAGUAGUGAUCAAUGUGCUGUUCAACUUUUCUACUCAGUGAGGAAUA	UCGUUUGUAGACUGACUUUC	-9.00
CGGUUUCCUGGCUUUCAUGAUAUUCAUGUGCUGGGUGGGGGACGUGUACC	GUUGUUGUCCUUUGAUGGAU	-21.20
AAAUCACCAGCCCUGCACUGAUGUCACUUUAUGUAGAAAAAGGCCUUAGC	CCGCCGUCCGUGUCCUGACC	-10.90
ACAUCAGCCACACCCUGCCCAUUGCUGCAUCCAGCUCUCUUGAUGCUCAU	GACAUGUUUGAUGAUGGAGU	-13.50
CAGCCCGUGGAGCUCAGGCCAACACCAGAGCCCCGGUUUUAGGGGCCAGG	CAGAGUGAAACAACGGGUCU	-23.60
UGGUUGCCAGGGGAUAGAGGAGUAAUUGUUAGUGGGCAUGGGAUUUGUUU	ACUUUGGUUCAUACCCAGCG	-12.90
ACCUAGCUGCCUGCACCUGCCCUUCAGGGAGAUGGGGGUCAUUAAAGGAA	CCUUCACGAUCGAGUCGUCA	-21.20
GCGCUCCACCAUCACAUCCCGCGAGAUCCAGACGGCCGUGCGCCUGCUGC	UCACCAGUAGCUCACUGUGU	-12.50
UCAGGGUUUCUUGGGGGCUUAUGAGUCUCACCGGUCAACCCAGGAGGCCU	GCACAGGGGUCACGGCACGU	-24.70
AAAGCCCCUUCCUCCCCAGCCCCUGCUUUCAUUAAGGUAUUUAAACUUGG	GUUCCGUCACCGGACAUGUC	-9.20
CAUGCAGACUGAGAGAGUGCCUUAUCCUGUAAAACCUUACAGCAAAAUGA	GAUAUGUUGGAGGAUGGAGU	-15.70
UCUUCCUUCGUGACAGGCCCAGGACCAUCAUGCUCAUGCUCACAGUGCCU	UACAUCAGGUUUCCGUGUAU	-11.00
UCUUGCCCUUCAUUAUUGCAGCCCUAGCAACACUCCACCUCCUAUUCUUG	GGCCAUCAGGGUCCGGUCA	-10.10
GGAAUCCACGGGCUGGAAGGACUCUGACUUACACAGCCAAGCCAGUGGGC	CUGGGUGUCUGUGCUCGAAC	-22.40
CCCGGGCGGCGGCUGUGUUGCGCAGUCUUCAUGGGUUCCCGACGAGGAGG	CUUCUUGACUUAAAGUCUCC	-19.50
AGAAACGCAUCCUGCACUGCCUGGGGCUUGCAGAAGAAAUCCAGAAAUAU	GAGUUCCUCGAAGUCAGAUC	-15.70
CAGACCUCCCUGAGUGUGAGCAGAGCUCUGCCAGGCAGAAGGCCUCUCUC	CGCCUGUGCUGUAAGGGCUA	-20.00
CUUCAGUCAGUCUCUGGGGAUGAAACUCUUAAAUGCUUUGUAUAUUUUCU	CCAUGGUCCUCACCCCA	-11.40
UGGGCAGCCAUGAGAACAAAACCUCUUCUGUAUUUUUUUUUUCCAUUAGU	UUUCAAGACACUACGUGACU	-9.90
ACAGGAGAUUGAGACCCGGCUCCGGCUGGCGGGCCUCACCGUCUCUUCCC	GUUCAAGCCUAGAUGCCCAA	-20.80
CCAUAUGUGUGUGGAGCACUCUGAGCACACACAGUACCCCUGCAUGGUUC	CGCAUGGUUUUCAUUAUUAC	-18.60
GCCCUCAGUGAGCUGCCACUGAGUCGGGAGCCCAGAGGAACGGCGUGAAG	GAAUCGUCCAACAUAAUAUA	-17.40
GAGUUAUCCUGGAUUACUGAAACAGAAAAAAAAUUGAUGUCUCUGGGUGA	CCCUCGCCCCCGGGACGGAA	-11.90
UGCCAAUCAGUUCACCUACUACUUCACAACCACCAACCAUUCAUUCAUCU	UUCUUCCCCCCCUUCCCGCA	-1.30
CCCUGGGGAUGUGGGGUCCCAGCUGCCUGCCUGCCUCUUAGGAGUCCUCA	UGUGGAUCCAAGGUUCCUAA	-20.20
UUUUCAACACUGACAGCACUUUAAAAAUCUUUGCCUGGGCCUCACUCUUG	AUUUGGUACUACACGACGAU	-4.50
CUCCAGCCUGGAGAGCAGUCGGCACCUGAGCCGAAGCAACGUCGACAUCC	GUACCAAUCUAGUUCGUGUU	-19.00
UCGCUGUAAAGGAGGAUGGGGAGCUCAACCUAAUGAAGAAAGCAGCCAGC	UUUCCGUCGUCCAGCAUAUC	-14.60
UCAAGGAUGCAGGGGCUGGGCUUCUUGCUGCUGCCAUGAUUGCUGUAGUU	CGGUUCAUUACCUCUUGUCC	-19.10
CGCGGGAGGCUGAGCUGGAGAGCCCAGAGGUGAUGCCUGAGGAGGAGGAC	UAGGGUAGGGGUCCUUGGGG	-21.80
GCGGGCUGUGACCAAGCCACGGUACAUGCAGUGGCGGGAGACCAUCAGCU	UUGUGUUCCAUGACCAUGAU	-18.30
UAUAAAGUGUGCCUGGCCGAGGUGUACCAGGAUAAAGCACUUGUUGGAGA	AGUCUUAGUGUGGACCCCCU	-24.00
GCCAUUGCUGAGGCCUGGGCUCGCCUGGACCACAAGUUUGACCUGAUGUA	UUCGUCGUGUCAUUAUAACC	-12.60
CUGCUAGGCCCCAGCCCCCAAAGGGACCCCCAGGCUGUAAAGGAGAGGGC	GUCUCUCAGUCUCGCGCCUA	-17.90
UUCAGGAGAAGCUGAGAGAGACCCAGGAGUAUAACCGAAUUCAGAAGGAG	CGGAGUCAAAGGUGUGGACU	-13.60
UUCAUGGAGGCUCUUCAGGCUGGUGCAGACAUCUCCAUGAUUGGGCAGUU	CACGUUUUCAUUGACAUCGA	-18.40
CCUUUGUGACUUCCGACCGAAGCAAGAAUCGCAAAAGGCAUUUCAAUGCA	CCUUGGCCGUAAACAAGACU	-15.70
AGUCCUCUCUCCUCCUCCUGGCUUUUGGAAAGGCUUGGCUGUGUUGGGGA	CCGUCCGUACGCCCGUCUGU	-20.70
CCUGAGGUGCCAUGUUUCAGAACAGAGUAAGACCCCUGGUAAAGAAGAAC	UAGUAAUGGUCCGUCAUAAU	-11.00
GUGGAUGGAGACGGUUUGUGGAAUUUUAAGUGCUCAUUGUAGUAAACUUU	UAGAUGUAACAUACGGUCCA	-9.00
UUGCUGAGUACCCGGGCAGCUCAGCUCAGUUGAGGGUGCUCUUGGCUUUC	GGCCAUCAGGGUCCGGUCA	-25.60
CUGAUGUGAUUGGAAAUCCUGAGGAGGAGAGACGAGCUGCUUUCUACCAC	CUUUGGUCGUUCACAACUGC	-14.70
CAGCAACGCGAGUGGGAGCACCAGGAUCUCGGGCUCGGAACGAGACUGCA	GGCUCAGAGGUAGUAGGUGA	-17.30
GUUGGUGACCUGUUCAGUUUGCUGCUAUCUCUUUUGGCUGAUUGCAAUUC	GCCCCUGCUUGCCCUGCCCA	-10.70
AAACAGUUGGGGAACUAGGGAGAAAACCAGACCAUUAAAACUGUUUGUGG	GAAGACUGGGAUUCAGGUCA	-12.50
CCGGAGAUCGGUGGAUCUGAGGCGCCAGCACCUCAGAACAAGGACCAGAA	UCAUUUGUAGGUGGAGGGUC	-21.00
AGCUGUUUUGGGGUCUGUGAGAGUACAUGUAUUAUAUACAAGCACAACAG	CACGGACUCCCUCAUUCUGU	-17.70
ACCCUGACGCCUGCUUCUCGGCUAAAGUGAACAACUCCAGCCUGAUAGGU	CGAAAAACCCCAUUCCCGAA	-12.40
CUGGAUUUCAGAAGGGCCUGACUUGUGAGAGUUGCCACACCACACAGUCU	UGUUCACGGAAGUGACGUCA	-16.60
UUUGACCUGGGGCGGAAAAAGGCAAAAGUGGAUGAGUUUCCGCUUUGUGG	GGUGAGUUGCCAGCUACCAA	-18.40
AACGAGACAUAGUGCUGCUACCACUGAAUAAGUGAUACUUUGGAAAGAUG	AUCACGUUGAUACGUUUUGA	-15.40
ACAUGGUCUUCCAGCCCAGUGUCAAGUCCCUGCUGCAGGUGCUGGGCUCU	GUUCGGGUCUGGCGUUUUUC	-23.30
AAACCUCCCUCCGCCCGCCCAGCAGCCCUACCAGCCCCAGCCUGUUCAGC	UCUGUGUAAACCUCUCCCUG	-4.80
CCGAGACUGCUCCUGCCGCUCCCGCUGCCGCGCCUCCUGCGGAGAAGGCC	UAGUAAUGGUCCGUCAUAAU	-17.70
CAGAAACCCGCUGUUGCCCCUCGCCAUGGCCUGCAGAGUCUCGGGAAAGU	ACCCCCUGCCUCGUCUUCCU	-16.00
ACACAAGAGCUGGAGCCCGUGCCCUACCACACAUCUGUGGAGAUGCCCAG	GGGCGGCGCAGCGGGACCCC	-24.20
UCGGGCCGCGGGAGCUGUGUAUCUGCAUGCGAGUCUGCCGAACUUGGAGC	GUUCUGGGGCCUCUAGGGUC	-22.30
AAGGACUUUGAUUUGUGGCACAAAACAUUAUUAAUAUAGCUAUUGACAGU	UUAGGAACGGGCCCACGUAA	-8.70
AUUGCACUUCUUAACAAAAAGGAACUUUAUAAAAGUUUGGGAUUUUUUUU	UCUGUGUAAACCUCUCCCUG	-11.70
GUGGAGAAGGUGGACUGGGACAAGGCCUGGGAAAUCACGAAGAAGACCUG	UGUUCACGGAAGUGACGUCA	-14.80
UCAAUCCCAACCUGCGCUGUGAUUUUAGCCUCCUGAGAUUGGAGUUUCCA	ACCGCGGGCUUGUCCCU	-14.10
CUGGUGGUCUCCUGCUUAGCCUGGUCUGACUGCAGUGUAGGGAAUAGGUC	CUCCCCGGAGUCUGGCUCGA	-22.90
UACUGCAGCACCUCCAGGCCUGUUGCUAUAGAGCCUACCUGUAUGUCAAU	GUUCCGUCACCGGACAUGUC	-21.00
CCAGUGCCAAAACCAAGAUCAAAAAGCAACCUCAGACCAAUACCCAGAGA	GCCCCUGCUUGCCCUGCCCA	-2.90
ACAGCUGAAGGCCGUGGAGGAUGCUAUUGCACGCAAGCGGGCCAAGAUCC	UAAUCCUUGUGUAGCGUUUU	-14.40
AACCAGGAGGGGGCUGAUCCUGAUAGCAUUGAAAUGGUGGCCACACGGGU	CUUCUUGACUUAAAGUCUCC	-13.50
CCCAGCAGAUGUUCGAUGCCAAGAACAUGAUGGCCGCCUGCGACCCGCGC	GCAUAGGCGUGUUUCGGAGA	-19.60
GACCUCGGGGCAGUGACGAGCAAAGACCAGAGACUGCUGAGCCCUCGCAU	CUCUCACAUCCUACAAAUGU	-10.10
CUGUCAUAGGGGCUUUCAUUAGAGUUAAACUUCAUAGAGUCAACUGUUUC	CUCUCACAUCCUACAAAUGU	-8.40
CUGUUCCAGCUCCUGCCUCUUUUAAGUUUGGUACUUCAGAGACAAGCAAG	AGGAGAGUUGGGUCGAAAA	-18.70
ACCCAGAUCCUCUCGGCUCCUCACCUUUAAUCCCACAUACUGUGCCCUCA	CUUCCUCGUGAAUCCCGUCA	-6.10
GUGCCAUUGCCCAGGCAGAGUCUCUGCGUUACAAACUCCUAGGAGGGCUU	UGACGUGAUCGGACCGACUU	-20.70
CCAUGGCCCAGAGGAGAAUGAGUAUAAGUCCGAGGGCACCUUUGGGAUCC	GGUUAUAAAGACACGACGAU	-13.60
UUCUGUUCUGCAGACACGCCUUCCCCUCAGCCACACCCAGGCACUUAAGC	CCAGAUGAGUGUAGUCGGAG	-18.40
AACGAGCCCACGGCCGCCGCCAUCGCCUACGGCCUGGACAGAACGGGCAA	UACAUCAGGUUUCCGUGUAU	-21.10
UUACUGUAGUUGGAGGAUGGAGAUGCUAUGAUGGAAGCAUACCCAGGGUG	CCCACGCCCUACGUCCCACU	-22.50
GCCUCGCUGGGGCCUCCUCCCCAGGCAGCCAAUGGGCCCCAGACAAGCCU	GUUCCAGCCAAGAUGCCCAC	-21.10
CAUGCAGGACGGGCCAGGCUGGGAGUGCCGCCUUCCUGUGCCAAAUUCAG	UCGGCGACAGUGUGCGUGUC	-25.90
GAGGGACAAGUAGGUGCCUUCGGUGCUCUUUUUGUCGCUUGUCUUUUGCC	CCUACGUUUGGACGUUUUGA	-20.20
UCAGGCAUUUGUCGGGGAGCUCAGCCAGUUCAACAUAUGGGACCGCGUCC	GUUCCGUCACCGGACAUGUC	-17.30
AGCAUGAGAAGCGGACUCUGUUUGGCGACAUGGUGUGCUUCUUGUUUAUA	ACUUUGGUUCAUACCCAGCG	-22.40
CUAUUCCCAGCAGAGCAGUCAGCCCUACGGACAGCAGAGUUACAGUGGUU	CUUUGGUCGUUCACAACUGC	-15.50
UACCAUCUUGGCCAGUGACAAGUGUUCGGAGGGCAGCAGAGAGGACCAAG	AAUUCCAAUCCCAGAGUCCC	-14.10
UGGAGCAGGUGUGUAACCCCAUCAUCAGCGGACUGUACCAGGGUGCCGGU	GUGGCUGUCGUUACUUACAA	-16.20
CCAGAAAUGCUGUUCUCACCAGAAUGCCCCCUCCCCUUGCCCUUACUGGA	CACUCGUGGGCCGGGGACGC	-24.00
AAAUAAGGAAUUUUUGGAAUUUCGUAAGGCAAGAAGUGACAUGCUUCUCU	UGUGUUAUUUACAAACGACU	-11.90
AACCGGGGAGAUGGGACGUGCCACGUCACCACCGCCAGCUUGGAUGGAGA	AGUGGGUCCCUGUUUCCUAA	-26.60
AUGACUAUGCAACCAUACCUUACCACUAAAUGUAGUACGCAAAAUGAUUU	ACCCUGAAACAUCCGGUCAA	-7.70
CCAACCCAGUGACCUUCAUGUCCAACAUGCUCUAUGCCUGCAGCAUCUUA	GUUCAAGCCUAGAUGCCCAA	-7.60
UGAGACGGAGCCUGGCUUUGGCUCCCAGGCUGGAGUCCAGUGGUGUGAUC	CCCACGCCCUACGUCCCACU	-27.40
GAGCCAGAUCCCCGGUGCCAGCUUAGGAAUAACCAGCGAUGGAUUUUUUC	GUUUGGUGUCACACGACGAC	-15.70
UGGCACAAUGGAGCGAUCUCCAGGAGAGGGCCCCAGCCCCAGCCCCAUGG	GUGUCGGGGGCAGGGAGGGA	-30.50
UGUAGGGAUCCCAGAGCGUUGUAAGCCUUCUUGUGAUUGGUAGGGAUGGC	CCGUCCGUACGCCCGUCUGU	-18.60
GACUCAUUGCAACCUCUGCCUCCCAGGCCCAAGCAAUCCUCCUACCUCAG	GACUCACAUAUUGUCUUGAA	-7.40
UUGGGCUCUGAGGAGAAUGGGCGCUAUUUUUCCCUGAGCUUGAUGAGUGG	UGAGGGUCCCACAUUGAGAU	-18.10
CCAACGGCGAGGAAGUGGCAGUGAAGCUAGAAUCUCAGAAGGCCAGGCAU	CGUGAAAAUACUUAUUCGAG	-14.20
UUUGUCGUCAGUGUCUUUUCCUUAGUCUUUUUGUUGUUGUUGUUGUUGUU	CCUUCACGAUCGAGUCGUCA	-9.80
CUCUGGAAUUCUCUCGGUGCCCGCCGUUGCCAUGCACUCGGCUGGAACUC	UGGUACCGACAUCUGACAAU	-17.40
GCUCAAGUUCAGGAGUGAGAACAACUGCUUCCUGUAUGGGGUCUUCAACG	GGAUAGGACCUAAUGAACUU	-13.70
UGGAGGCCUGGGACUGGGACAACGAUACCACCCCGAAUGAGGAGCUGCUG	UCAAGAAGUUGACCGUCGAA	-15.50
CAAUGGGAAGGAGCCUGAGCUGCUGGAACCUAUUCCCUAUGAAUUCAUGG	AGUCCGUGCCGGCCCGGUGG	-21.40
CAUUGUUCUGCCACAGCCCUGCAUACUGACCCCGGGAGGCUGGGCAGGUG	UUUAAGCCUAGAUGUCCCAU	-21.20
UGGGCUUCAGGGAAGGUGAAGGAUUGGGUAAAUACAGCCAGGGUCGGAAG	UGUUUAGAGGUCUGGUGGGU	-12.40
GAAGAUCAACCCCGAGCUGGUGUGCUGCAACCCCCAUCACCUUAGCCGAC	GGUCGUCGUGGACCCCGUCA	-13.70
CUACUACCAGCACCAUGCCCUACCAAUAUCCAGCACUGACCCCGGAGCAG	AGCCCUACCGCGGGCAAGUG	-12.20
AAACCAUAGGCAGAUGAUAAAGGAAGCUUUUGCUGGGGAUGAUGUCAUCA	GGGCCGGACACACCACGAGU	-14.90
CGUUGGGGACGUGCUGGUGUUAACCAAACCGUUAGGAACCCAGGUUGCUG	CCGUCGUGACAUUUCUUCGA	-17.60
GGGAGAACGUCAUCAGUGUCGCUGAGCUCAUCAACGCCAUGAAGCAAGUC	GGCGCGUCGGGGUACCGGUU	-18.00
UAUAAAAGGGACUGAGAAAUUUAUAAACUUUUUUCUUACUGUCUUUUUUC	UACAUCAGGUUUCCGUGUAU	-11.80
UCGAGAUUGGAAUUCUCGGAUCCCGAGAGAUGUCAGAGACACAGUACUCG	GAAUAGUCCAACAUAAUAUU	-15.00
GAGCAGGAGCAGAUCCGGGGUAGAGGGAAAAGAGCUCCGGGCCAGGGGCU	ACCCUGAAACAUCCGGUCAA	-24.20
UCCAGAGACACGAGCGUGUGUGGCAGCAAGAGCCGCCAGUUCGGGACCAC	AGGAGAGUUGGGUCGAAAA	-21.80
AACACUGAUGGAACCCAUGACUUCACCAGGAUUGUGGUCUACAUUUACAG	CGAUACGGUCGUAGAACGGA	-14.90
GGCAAGCGGGACCCCGAGGACUCGGACGUGUUCGAGGAGGACACGCACCU	UUAACGGGUUCAGAGGCGGA	-23.70
UGCACAGGGGGCAGACAGCGUGGAGCCUAUGUUCCGGCAUCUCAAGAACA	GAGUCGCCGGCAAAGGGGUU	-20.90
CAAAACCCACCCCAUUCCUCCCCACACUCAUCGCCCUUACCACGCUACUC	GAGUCUUGGGUCUCCAGAGU	-10.70
GUCACCCUCUGUUGUUGGCUCCCACCUCUUCACAUGUUCCAGGGUUGAAC	CAAGAGGGUUGCAUUUGGGU	-13.30
GUUCCCGGUAGGGCGAGUGCACCGCUUGCUGCGCAAAGGCAACUACGCGG	ACUUCUAAUGACCCCCCUUC	-17.10
AGACGAUAUACCAGCCCUCACCCAGGUUUUAAAAAAGCACUGGUAGGCAU	CCCUCGCCCCCGGGACGGAA	-16.30
GAGCACCAACGGCACAGCACAGACACCUAGUGCCUCUCGGAAGUCCCUGG	GUUCGGAACCCACACCCUCC	-14.40
UCCUGUUCCCAAAGCUGAGCUGAUCUGCCACCUAGAGCAUGGGCAGGAGC	ACUGAGAUAGGAUACAGAAA	-16.20
CCCAGAACACUGGUCUCGGGCCCGAGAAGACCUCCUUUUUCCAGGCUUUA	UGUGGUCCUCUUUAGCCAGU	-18.70
GGUGCUGGAUGUUGUGAGAAAGGAGGCUGAGAGCUGUGACUGCCUGCAGG	UGUUUAGAGGUCUGGUGGGU	-15.30
CCAUUGCUUACAGUAGAAGAGUGGGGCUGUAUGCUUGAUAAUCUUGAACA	AAGGGGAUCUAUGCUUAAAC	-12.30
CAAAAGGUAGAAAAGAGUGUGGAGGAAGAUUAUGUGACUAAUAUUCGAAA	GCACCAAGAUGGGACACCAU	-10.30
GGCACGGGCCACGCCGACACCACCAAGUGGGAGUGGCUGGUGAACCAACA	UGGGGACCUCUAAGACUAUU	-25.70
UGGACCAGUCUCCUCGAGGCAUGAAAAUCCGGGGCAACAUCAACAUCUGU	UUCUCUGGCCAAGUGACACU	-15.70
AUAUUCACAGGAUCUACAAGGCUAGAUGGAAAUGCCAUUGUGGAUUUUGU	CUCCCUCUGGGUCCGAGCCU	-21.70
CAGGGAGUGACCCACUGGGCCUCAUUGCCUACCUCAGCCACUUCCACAGU	AAUGUUAUGUUAGACUAUUC	-17.50
AAGUCCACCCGUUUCAAGCCUACCCGCAUCAUCUUCUACCGAGAUGGGGU	UGCCCUCACUAGCACAGUAA	-14.60
GUGUCGAACUCCCAGCAGGCUUACCAGGAAGCAUUUGAAAUUAGUAAGAA	CGUUACGUUGUCGUUACGUG	-12.60
CAGGCCCGUAACUGUCUACUACUUUGAUAUAAUCUGUAUACAUCCUGUAU	CGCCUGUGCUGUAAGGGCUA	-10.10
UACUGCAGUGGAGUGGAGUCAGCCAUCUCUAGUUUAGACUACAUUUCUAA	GGUGAGUUGCCAGCUACCAA	-13.70
GCAGACUCGGGGGCCAGUCCUGCACCCACCUCUACCCCUCGCCGACAGCC	CGGGAAAGUAGUAACGUGAC	-14.40
CAUCACUUUGGGUCCUCAGGAAUGACAUUACAUGAACGCUUUACUAAAUA	GGAAGAGUUGGGUCGAAA	-8.80
GAUUUUGGGGGUGCUGUUCAAGAUUAUUUUAAGUGGAAGGCCGACAUGAC	GGUUACGGGAUCCCCUACGC	-17.80
AAGAACCACACCACACACAACCAGUCCCGAAAAUGGCACAGAAAUGGUAU	CCGUCCGUACGCCCGUCUGU	-7.90
UAACCUGCAGGACGUGUGGGAGACGAGUGAAGGCGAGUGCAAUGUCAUGC	GGGUCAUCGGUCUACAUCGA	-16.10
UGAGAAGAGGAAACGUCAGCGCCAAAAGAAGGCUCGGGAGGAACGCCGCC	AGAUCAUUUAUACAGUCGUA	-17.60
CGCAAGACUGUGGGCGUGGAGCCGGCAGCCGACGGCAAAGGUGUCGUGGU	UAGAUGUAACAUACGGUCCA	-23.80
UACCCCUGCCUGGAUGACUUGGAGGGCCUAGUAGCUGUGGGCCGGGACCU	ACAUAUACGGGUACCUGACG	-22.10
CUUCCUGGGGACAAUGUGGGCUUCAAUGUCAAGAAUGUGUCUGUCAAGGA	UACCACGAACUGCCUUGGUA	-14.00
AUUGCCACUGUGACGCUUUUGAGUUAUGAAGAAGGGUAGCGGCCUGAUGC	UCUCUGUUAUAACUAUCCCA	-13.40
GAGCGCCGGGACGCCAAGCACUUCCUGCCGCGGGCGGCGCGCCGCAGCUG	UCUUCCGUGGUACCCUAAAU	-24.90
CCGGAGAUCGGUGGAUCUGAGGCGCCAGCACCUCAGAACAAGGACCAGAA	GUGGGUCUAGACGCCGGAUU	-24.50
AGGUGGGGCAUGGUGGCUGGAAGUAAAACUGCCAACUCUGGCCCUCAGAA	AGGUCAGCCCCUACAAAUGU	-20.10
CAGAGCACCUCCGACUACCUUGUGGUCUACCUGCGGCUGCUCACCUCGGG	CUCUCCUCACGUUGAUCGUU	-17.70
CUGGAAGGCUGGGAGCCAGAUGACGACCCCAUUGGGCCGGGCACGGUGGC	GACCUCCUUCCCGGGUCUCC	-29.70
AUCCGCACUAGAAAGUUCAUGACCAACCGACUACUUCAGAGGAAACAAAU	CGAUACGGUCGUAGAACGGA	-8.10
AGAUCGCCCUAAGAACCUGUGAGCUUAGAAACAGCUUUCAGAGACCAGAA	AUCACGUUGAUACGUUUUGA	-13.10
UGAUUCUAACAGUUUAAUAAAAAAGUAUAAUUAUACUUUAAGUGUCAACA	UCCAAUUUCCCAGAGUCCCU	-8.50
CCUCCAAGACCUUUACUACCCAGGAGACCAUCACGAAUGCAGAGACGGCG	ACCGUCUGACACUAAACAAC	-10.70
UCGCUGAGGAACAAGAGAAGGGGGGAAAGUUUAGGCGAGCCUUGGGGGGG	UUUUCGUUGACUCCAAGAAC	-14.70
ACCCGCACAGCAAGCACCUGUACACGGCCGACAUGUUCACGCACGGGAUC	UUUCAAGACACUACGUGACU	-11.80
AAAGCUGUCAAACAUUUACUGAAAAUAGAAUUGGCCCCAUGGCUUGAUGU	AUCUCACGUCUGGUCCCAGA	-8.60
AGGAGCCAGCACGGGCUGAGGCCCCACGCAAGACUGAGAAAGAAGCCAAG	GUCUUGACAAGGGCGACGAU	-15.70
UUCUCUGCCAACAGCUCCUCUUCGGCCUCCGUCACAGCCACCUGGACCCU	UUCGGUGGUACACUUUGGUC	-19.00
GGGCUAUUGCCUCCUCCCAGCCACGUUCCCUUUCCUCCUCUCCCUCCUGU	UUUCGCACCCCCUUUGUGCC	-9.50
UUGGUUGAAGUCGAGUGGGAAGAGCACCUAGCCCGGAAUCCCCCUACAGA	AGUCUUAGUGUGGACCCCCU	-16.20
CUCUUUCUGCAUCAGGGACAGGCUUUGGAGACAAAUUUAAACCAGUGAUA	AUGUCGAUCUAUUGGUUUCU	-11.60
CAGCACCUGCCUACUAUGCCCGCCUGGUGGCUUUCCGGGCACGAUACCAC	UCCCUUGUGUCCCGACCACU	-16.80
UGAACUCUUGGGGCUGAGCUGCAACCACCCAACUUUCUUUCCCACUCUUC	CGGGACCUGAUCCUCAGUCG	-14.30
GGCUGGAUGAUGACCCACCUCCCUCUACGCUGCUCAAAGACUACCAGAAU	GACGUGGCGCAGGGCAGGGA	-16.20
AUAUGAAACAUACAAGGAAGCCCAGGCUGCUAUGGAGGGACUCAAUGGCC	UAACGUUGGCUAGGGUUGGA	-17.90
UUGAUCUGGAUGGGCCCAAAGUGGCAUCUCCUUUGUCCCCCACAUCCCUG	AUCACGUUGAUACGUUUUGA	-14.50
GACAGUGAAUCCUUGGCAUAUGAAGAAAGCUUUCAAAGUCAUGAACGAAU	GGGACGCGGUAGAGGAGAUG	-11.00
CAAGUGCAAUGCCUGAGGGGAUCAGGCUUUUCUACUCCAGGCAAACCUGC	UUUAAGCCUAGAUGUCCCAU	-19.10
GCCUUGUACCAUUUUUUAAAUAGAAGUUACUUCAUUAUAUUUUGCACAUU	GACGUGGCGCAGGGCAGGGA	-9.10
GAAAAGAUGCCUACCUCAGCUAUUUUGCCUGAUUUUUCUGGCUCUGUAAU	GAAGACUGAGGUUCAGGUCA	-18.00
ACCACCAGCCGGGGACUGGGCGCUACCAGGUGCUUCUUAAUGAAGAGGAU	UUCGUCGUGUCAUUAUAACC	-19.30
ACCAACCUAUUGCCUAUGAGAAACAUGUAAGAUAAUGUAUUUACAGCCAU	CGAUACGGUCGUAGAACGGA	-13.90
CAUCUUGUGGGGCCAUCCAGUACAUCCCAACUGAGCUGGAUCAAGUUAGA	GCCUUGAAUCGGUGACACUU	-15.30
UACAAAGUUGCUGCAGUUAAUGGAUACAUUCUGUGCUCUGAGAAUCUGAA	UGGUACCGACAUCUGACAAU	-12.30
AUCUGCAGCAAGUAGUCAGCACUUUCAGUGAUAUGAAUAUCAUCUUGGCU	ACUUAAGAUGGUCACGGUAU	-11.80
UCUUGUAUUCCAUCACCGGGACAGCUUCAACACAGGGUCCACAGCGUGGG	AUCGGGACAUGUUACGACGA	-16.00
UUUCCCUGGACAGGCAGCCUCCUUUGUGUGUAUUCAGAGGCAGUGAUGAC	AGUGAGGGUCCGUCGACGUU	-25.70
CGUGAGCUCUAUAUCUGUGAAUUCAACCAAGUUUGGAUGGAAAAUUUUUU	GUGGGUCUAGACGCCGGAUU	-16.50
AAGUGGACCCAGCGAGAGAAAGGCAUCUUCAAACUGGUGGACUCCAAAGC	GCUGGCUGCGGUGCGGCUCA	-16.20
AGGAUGGAUGGUGGAAGGUGGGGACGUUGGUGGCUGGCUGAGGUGCAUGG	ACCCGAAUGCAACCCUCUUG	-17.80
CGCAUCCUCGGGUGCCAGUGCCGCGGCCGCGGCCGCCGCCGACGCCGCCG	GUUGAAUCAUUACACGUUAU	-30.40
CUUUUUCAGUGAUUCUAGCAGAUGCCAUCUAGUACAUCCUUGAUCUUGUU	GGGUCAUCGGUCUACAUCGA	-12.30
GAAGGCACGUGGGCCUGGAUUGGAGAAGACAGGUGUGGCCGUCAACAAGC	UUUAAGCCAAGAUGUCCCAU	-17.40
ACAUGUGCCCUGGGGGUUCAGCCAAAAUGUCUGCUGUGUCCGAAGAAGGG	UUUUCGUUGACUCCAAGAAC	-15.20
GUAAGGAGCUGGAGUCGCUGGUAGAGAACGAGGGCAGUGAGGUGCUGGCG	GGUCCGGACGUACGGGAGUG	-19.40
UAAAAGAAGUCUACCCAGAAGCUAGAAAGAAGGGCACUCACUUCAAUUUU	GGGUCUCGGAGUCGAGGGGU	-18.00
UUCAAGGAGAAGGCCCAGGCCAAGGUGGGAUCCCUCGAUAAUGUGGGCCA	GUGGCUGUCGUUACUUACAA	-15.80
ACGUGGAUUUUCCAGGGCUUGGGAACUGAUUCUUGAGCCCAGAAGAGCCA	UUAGGAACGGGUCCACGUAA	-22.70
CAGAUUGGAGGACUGAAGCUGCUAUCGAACUCAUCAUCCUUAUGGAGGUC	GCUUCGAGGUUCCAAGGAGG	-17.80
GCGAUGGAAGGCCUCCAACCUCCGAAGAGCUGCCCAGCUGCUACACUGGC	CGACAGUUAAGUAUCCAGUC	-12.90
CAAUGCGGUCCAGGGUCUACGCCGCCAUGAGAUCCUCCAGUGGGUCCUCC	GUUUGGUAAUACACGACGAU	-14.80
GAUGGGAGUGUCGCUUGUAUGUUAUCGUACAGCUGACAUGUAUUUUUGUC	UAGUAAUGGGCCGUCAUAAU	-18.90
CCAACAGCUGCGGGACUGGCAUCCGCUCGUCCACCAGCGACCCCAGCCGG	CUUUAGGGACCGUUACACUA	-24.40
GCGUCUUAACACCUAACCCCAAAGGCUCUUUUAAGAGCCACCCAGAUACC	GUCUCUCAGUCUCGCGCCUA	-14.90
CGACCUGGGCAGCGGCAUCAAACUCAACGGGGACUGCUCCCCUAUCUCCA	CUUCCGUUAUCUAACAUAUC	-16.40
CAGGGCUUGUGGGCCAGGAGAACGCGCGAGAGGCAUGUGGCGUCAUAGUA	CCUUGGCCGUAAACAAGACU	-17.00
ACAAGCGGAUCUACAAGGGCACCCAGCCCACCUGCCACGAUUUCAACCAG	ACUUCUAAUGACCCCCCUUC	-11.20
CUGUAGCUUUGGAAGUUUAGCUCUGAGAACCGUAGAUGAUUUCAGUUCUA	CACGUUUUCAUUGACAUCGA	-16.40
ACUGAUGAGGCCCAGGAAGAGCUAGCUUGGAAGAUUGCUAAAAUGAUAGU	UCCCGUCCGUGGCCGUGAGU	-14.30
GCCCAGAUGGCUCCUGGACAUUUGCCCAGCGUCCUACUGAGCAGGAACUG	CCGACGUUGUGUUCUGUGCU	-16.40
CUCUGUUAGGUUCUGGGGCUUGCAAUCAUUUGAAUUGUUCUGUUUCACAA	GAGGGUUCUUGGAGUGGACA	-12.20
GACUCACGCAGAGCACUGUCGGCAUCAUCGGGCUGGGGCGCAUAGGCCAG	GGACGUGACAUUCGUGAAAA	-24.30
GUGAAGACGCAGAGGGAGACAGGAGGUUUCAGUCAGGAAGAACUUCUGAA	UUUCAAGACACUACGUGACU	-16.60
AGGUGUCUGUGUUCUUCGGUGGUCUCUCCAUCAAGAAGGAUGAAGAAGUG	AAUUCCAAUCCCAGAGUCCC	-19.70
CCUCCUCCCCAGUGCCUUGUCUGGCUACCUCUCAUGCACAGGCUUGCCCA	GGAAGAUGUUUAAGUGGGUA	-17.60
CUCCACCUCCCAUAGUUCUCCCGCGUCUGGUUGGCCCCGUGUGUUCCUUU	CGACAGUUAAGUAUCCAGUC	-10.20
CCACCGGGGACCCAGGGGGACUCCACCCCCCUAAGCAAGCACACACAUAC	AGUCUUAGUGUGGACCCCCU	-25.60
ACUGCCACCUUCUGUACGAGUUUGUUUGUUUUUUUUUUUUUUUUUUUUUU	GUACCGGUUUUGUCUCUUCU	-5.70
GGUCUCUAAUGGAGCUACAGGGACAUAUUGGAAGAUUCCAGCGCCAGUGC	UGGUUAGCGGCAGGGGCGGC	-20.20
CUGGAGGGGGAUUGGCUGCAGUGUAGAUUUGCCUCUGAGGAGGCUGCCCC	GUAAUAAUGAGUGCCAUGCU	-17.00
UGGAGGAGGAAGCCAGGCGGCUGGCGGAGGAGGAGAGACGGAGGAGGCCG	UUAGGAACGGGCCCACGUAA	-16.00
CCCCGAGCCGCCAGAGCCCAAGAGGAGGAAGUACGGCGGCAUAUCCACAG	GUUUGGUGUCACACGACGAC	-22.10
GGGACAGGAUUUGACUGUGCUAGCAAGACUGAAAUACAGUUGGUGCAGAG	GACCCCUUUUCCCACCGUGC	-19.70
CGAGACCAUCAAAGCCCGGAUGUACGUGGGCCUCACCCCAGACAAGCGGU	UUAACGGGUUCAGAGGCGGA	-16.90
ACUGCCACCUUCUGUACGAGUUUGUUUGUUUUUUUUUUUUUUUUUUUUUU	CCGUCGUGACAUUUCUUCGA	-7.10
ACAAAUUCCCCUUCCUCCCUGCCUUCUGAUGGGGGCUGGGCAGGCCAGCU	UGGUUCUUUAUCGGAAAGUU	-22.10
ACGAAGGGAGAAGGAUGGCCACAAAGAUCCUCUCUUGGUGGAGGUGAGUC	AGUGGGUCCCUGUUUCCUAA	-24.90
GAGGAGGAAACCAUCCUCUGCUGGUGCCCUAUGAUACACUGACAGCCAAA	AUGUUAGUUGCCAGCUACCA	-13.20
CUUCUUGCACUGAUAAUGCACUUUGAAGAUGGAAGGGAUGGAAACAGGGC	GGCCGCGGCUCCCGGGCUA	-15.50
ACUUGCCACUAACCAAGAUCACCUCUGCAAAAAGAAAUGAAAACAACUUU	AGUGGUUAGUCGAUUCGAGA	-10.80
GUCUACCCUGCACCUGGUGCUCCGUCUCAGAGGUGGGAUGCAGAUCUUCG	AUCGUCGCGGAGUGCAAAAC	-22.20
UAUAUUCUCAGGGGCCAAGGCUAGGUCUGCAACCCUCUGUCUCUGACAGA	ACUCCGACACCCCGACCUCA	-20.70
AUAGAGUGUUUACCAUGAACAGUGUGUUGCUUCAGACUAUUACAAAGACA	CUCCGGGGACGGCGGGGC	-15.30
GGCAGCGGGCUCGGAGGCAGCGGUUGGGCUCGCGGCGAGCGGACGGGGUC	CGACAGUUAAGUAUCCAGUC	-24.00
CAUCGGGGAGUACAGCUGCUGUUGUUACUACCCAGGGCUCAGAGGCACUG	UCUGUGUAAACCUCUCCCUG	-21.70
AGACCAGAAGCCAGAUGUGAUGUACGCGGACAUCGGAGGCAUGGACAUCC	ACCGCGGGCUUGUCCCU	-15.80
CGCCAUGGCCUCUGUCUCCGAGCUCGCCUGCAUCUACUCGGCCCUCAUUC	UUCCGGUGUAGGUCGUGGCA	-19.10
UUGACCUCCUGGGGGAGCUGAUGAAGUUCAACGUUGAUGCAUUCAAGAGA	CGACAGUUAAGUAUCCAGUC	-12.70
UCGAAUGAUAACAGAAGGCGGAGUCAGCAUAAAUCACCAACAAGUAACAA	AACUGUUAUAGUAACGUGAC	-11.40
AGACAGGCUCUGGCAGUGCAGAUCUGCUGAUCCUCAGCGCCUGCCAGGAG	UUUAAGCCAAGAUGUCCCAU	-26.60
ACUCCAGAGUCCUCACCGGUGCAGAGUUGGCACAUAUUAAUUAACUAAAA	UUUCUGUCAUCUGACAUAUC	-7.90
UGAUGAUCUGGUGGUGGAUGUUUCCAAUGAGGACCCCGCAACGCCCCGGG	UUCUCUGGCUUGUCCAUAUA	-15.80
AACUGGGGCUAGGGGAAGAGCAAGCAAAAAGGGAAGAAGGACUCCUAGGC	UACCACGAACUGCCUUGGUA	-15.70
AUGAGCGGGCCAAGAUCGAUGAUCCCACAGACUCCAAGCCUGAGGACUGG	UGCUACUGUUGCUACUGCAU	-15.50
GAGAAUGGUGUGAACCCAGGAGGCGGAGCUUGCAGUGAGCCGAGAUAGUG	GUCUUGAAUCGGUGACACUU	-15.70
GAAGGUAAAGAGGGUCAUUGGGGUCGAGCUAUGCCCAGAGGCUGUGGAGG	GUUCCGUCACCGGACAUGUC	-22.60
GAUAAAGGACUACUUGGGGAUAUUGCCAUUCACUUGAGAGCUCAACCCAA	ACCCUGAAACAUCCGGUCAA	-13.80
UGCCAGUGCCAGACCUGCAGGCGAUUCUGUCAAUAAAGACAGUAUGAAUG	CUCCCUCUGGGUCCGAGCCU	-21.10
AUUUGCCUCCUAGUUCACUUUGUGUCAAGAGCUAAAACUGUGAACCUAAC	UUAGGAACGGGUCCACGUAA	-14.60
CUUGGAGACCCAGUUGAGAAAGCUGCCCAACUAAGACCUAUCUCCCUACC	GUGUCGGGGGCAGGGAGGGA	-21.90
GGCUGCAAAAUUCGGGUUCAGGGGGACUGGAUCAGAGAGCGCCGCUUUGA	GUAGAGUGACAUCGGAGUUU	-20.50
UUGCCUCUGGAACCUCUCAGCAGACCAAAAUUGUCAUUGAAGCAGGGGCU	UAGGGACCCUGGUAUGGAUC	-17.10
CCAAAGAACAGUUUAUGGUCCAGAGAGGGACAACCCCAGAUAAUCUUUCC	GACCUCCUUCCCGGGUCUCC	-21.40
ACCCUGCCUCCCUCUCUCCAAAGAUCUUUGUGAGGUGAGCCUUGCCAGCA	UAGUAAUGGGCCGUCAUAAU	-16.50
AACAACCUGCAAUCACGCACUUUAUGCUAUUUGUGAUGUUUUUACCCAGU	GUGGCUGUCGUUACUUACAA	-10.20
UAAUGCUGUCCGCCAGGCCCUGCAGGACCUGCUUUCGGAGUACAUGGGCA	GUGUACCUCAACGACAAUGU	-19.40
UGGGAGAUUGGGCCUGAAUUUCUCCACAGAAAUAAGUUGCCAUCCUCAGG	GGCCAUCAGGGUCCGGUCA	-16.40
CUUCGCCCCUACAGGCCACAGCUGGACCAUCUUAUCCCCGGCCUGUGAUC	AAGUCCUUGUAUAACGUUUU	-16.20
AUCAUGCUGCAGCCCAGGGGCGUCUGCUGUGCCCCGCCAAUCACGAGACU	ACAUUUGUAGGCUGACUUUC	-16.50
AGAUAAAUAUUUGGCUUGUGUAUUCCAUAUAAAAUUGCAGUGCAUAUUAU	GGUGAGUUGCCAGCUACCAA	-11.30
CGCAAGACUGUGGGCGUGGAGCCGGCAGCCGACGGCAAAGGUGUCGUGGU	UCCGACCCCUAUUUACUUAU	-22.50
CUGACACGUCCACUUACCAGUAUGAUGAAUCUUCAGGAUAUUACUAUGAU	AGCCUCACAGAGUCUUGAAA	-11.00
ACCCCUAACAGGGGCCCUCUCAGCCCUCCUAAUGACCUCCGGCCUAGCCA	CACCUCGGGACUCUUGGCCU	-23.30
GAAACUAGGGGAAUUUCAGGGGACAGAGAUGGGAUUUGUUGUAUGAUAAA	GUCUCUCAGUCUCGCGCCUA	-17.40
AGCUUCAUGACUCCUACCGGGCCUUUCGCUCGGAGAACCUCAAUCUCUCC	UUCUCUGGCUUGUCCAUAUA	-14.20
GCUGGUGAAGCGGGUCCGGGAUCUCUACCACAAGCGACUGCCAGACGUCC	UUGGUCGAUUCUGUGACGGU	-23.40
GGCCUGCGGGGACAUUCUACUGUGCUAAAAAGCCACUGCAGACAUAGCAA	UUAACGGGUUCAGAGGCGGA	-15.30
AGUCCUCUCUCCUCCUCCUGGCUUUUGGAAAGGCUUGGCUGUGUUGGGGA	ACGUUUGUAGGCUGACUUUC	-15.80
AAGCUGUCAAGAGACCCCCCAGCAUCACGCGAGGAUAACCCCAAGGGGCG	UCGUAGUCACUAAAACAACU	-16.00
AUCGGGACCCAGCUCGAGUAGUAGUUGUGGACUGCAAGAAGGAAGCCUUC	GACCAUGUUCCCAACCCUCU	-16.50
ACUUCCUUUCCUACUUGGAUUCUCCUGCUCGCUGCCUCCCAGCAUCUUUU	CUUCUUGACUUAAAGUCUCC	-8.10
CUCUUGUACCGUUGCCCCGCUCUGUGCCCCACCCCCACCUCCUCCUCCCA	CGCCUGUGCUGUAAGGGCUA	-10.50
AGCAAUUGAUUGUAGCAUGGGUUCCUCCAAGGUUUCAAGCAAUGGGCAGA	GGCUCAGAGGUAGUAGGUGA	-12.60
UCCAAAACCAGAGCCCAGGCCUAAAAAGGCCUCUGCAAAGAAGGGAGAGA	GGCGCGUCGGGGUACCGGUU	-23.10
AGCAUGGCCAACAGGGGACGUUUCCAGUCGAUUACCAGGAAAUGCAAGCC	GGAGGUGGUACGUUCCCUAC	-22.40
GACCAGCCUGCACUGUGCCUUAACAGAAGGUCUUGAGAUUCUAAGUGGGA	UAGGGACCCUGGUAUGGAUC	-17.70
GGUGAGUACAGACAGUGGGACUCAGGAGACAAAGAAAACUGAAGACCGGU	GUUUGGUAAUACACGACGAU	-10.10
CCACCUUAGCCUCUGACUUCCUAAUGUAGGAGGUGGUCAGCAGGCAAUCU	CGUGAAAAUACUUAUUCGAG	-21.40
AACCUGAUCUGCUGCCUCCUCUGAAAUUAGAAGCUUGUAUUCUGACCCAA	GUUCGGGUCUGGCGUUUUUC	-12.30
UUGCCUGAUCUCACUCAUUGCACUUCCUGGAGUUAAAUUUUCCAACAGCC	CUCCUGUCCAUUGUGCCUCC	-9.20
CAAAGACUCGGAAACCAAGUUAUUGCUAUCAGAGGAAGAAAUAGAAAAAG	UCAUUUGUCGGAAGAGGGUC	-8.00
GAGCACUCAGAUGGGAAUAUGGUAGCGUCUUGCCAAAUGCAUUACGAUUU	GGACGUGAUAUUCGUGAAAU	-15.80
AUCCCACAAAAGUGCUGCAGAUGAUUACAAUAGAAUUGGUUCUUCAUUAU	GGACUAAGUGUUGUGGUCGA	-11.10
UGACAAUUAAACCCCCUGGGCUUACAGAUCUGGAAGUAACACCUCCAGUA	GUUUUGUACUUAACGACGAC	-10.30
CCUCUGGGUUGGGAUCAGGGGUAGGAAUGGAAAGGAUGGAGCAUCAACAG	AAGGGGAUCUAUGCUUAAAC	-16.80
CUUGACUCUCUGACCUGUGGGAUGCACAUUCUUCCUCAGCGCUUUUUCCU	UAACGUUGGCUAGGGUUGGA	-16.00
CGGGAGAAAGGGGGCAGUAAUUACCCAAAUCCGGUUGGAGCAUGACGUGA	GGAAGAUGUUUAAGUGGGUA	-13.40
AGCAAACAGGACGGGAAGAUUUACAGAAGCCGAGACCCACAGCUAUGCCG	ACUCCUCUCUCCUCCACCCC	-10.30
ACCCAGUUGCCAGACUGAAAUCUCAGAUUUCAGUACAGAUCGCAUUGACU	UCUGCCCUCCUCUCCUCACU	-12.80
CCUCCACACCAUCCUUACUAUCAGCACCAUGCUCCACCUCCUCAAGCUCA	CGAUACGGUCGUAGAACGGA	-13.30
GGAAUAUUUCAGGCAAGGGAUGAUCAUAUAUGACAAAAUGUCCAUUUUCA	CCGUCGUGACAUUUCUUCGA	-8.20
UCAUGCCUGGAUGGGGACUGAGCCACCAGCCUGACACCCAGAAGGCGAGA	UCUUCCGUGGUACCCUAAAU	-22.50
UGUGCCCCUGGGACGAAUGCCAUCAGCUGGGAUGCAGAACAGACCAUUUC	GAUCUGACACUCGAGGAGCU	-14.10
AUGCCCAAGGACAUCCAGCUGGCCCGCCGCAUCCGUGGAGAGCGGGCUUA	UCCAAUUUCCCAGAGUCCCU	-20.20
AAAAAACUGGCUGAGGUGUGGAAGCAAUUACCAGAAAAAGACAAACUGAU	ACCCUGAAACAUCCGGUCAA	-9.70
GUUUAUCUCAUGGAGCACCUUUGCUGAAGCAGCUUUGUGAUCACAUUUUA	UGUUCAAUCCCAGAGUCCCU	-15.70
AGAGACUCCUCAGGCCAAGAAGAUAAAGCUUCAGACCCCUAACACAUUUC	UCUGGCUCUGUUCACGUUAC	-12.30
GGAAGGAUAACUGGGUGAGCUUCAUGGACACCAUGCUGCAGAUGUCCAUC	CGGUAAUGAAAACGUGGUCG	-15.10
UAGUGAUGGGAAGCAGGCAGUAAGCUUACUUAGAUGGUGACAAAAGCAAA	UUUCUGUCAUCUAACAUAUC	-12.80
AUGCACAGGCUGACGGACAAGCAGCGGAAGCACCUGAGCAUGAAGAAGAC	ACCCUCCUCCCUCUUCUCCU	-18.10
UUUGCUUCUCUCCACCCAUGACCUUUUUCACUGUGGCCAUCAGGACUUUC	GUCGGGUAGCUGACCACAAC	-14.30
UUGGGAAUGGUGCUUUUGCCAACUUAAAAGGAUUAAAGUAACGGAGAUAU	UCGGCGCUCCUCGGCUCUCU	-13.30
CAGGGUGUCUCCAGGGCUCAGCUUCCGGGGUGGUAGAGCUGGGGAGCCCC	GUUCUGGGGCCUCUAGGGUC	-25.90
UAAUGCAUCUUUUGGAAAACAAAUACAUGCCUACUUUGUGCAUAUUUGCA	GAUAUGUUAGAUGAUGGAGU	-14.10
GAGAUUGCUGUGCAGAACCCUCUGGUGUCAGAGCGGCUGGAGCUCUCGGU	ACCCACACACGUACUCGCAC	-21.40
AGGUCUUUGCUGCAGAUGGUGCCUCCACUGAGACUUCCGCAUCUGGGACC	UUCGAACGGUGACUUCUUGA	-17.10
GGCACGGGUCGGGGGUAGUGAUGAAGAGGCCUCUGGGAUCCCUUCAAGGA	CUCUCCUCACGUUGAUCGUU	-19.30
CAUCACCAGAGGUGCCACUGUGACUCGAGGCGUGCCACCCCCACCUACUG	AGUCUUAGUGUGGACCCCCU	-18.00
UGGAGAAGGCAGCUGGGACCGAUGUCAACAACAUCUUCCAGCUCACUGUG	UGAAAAACCCCAUUCCCGAA	-22.20
AGAGAAGGGCAAGCGUGGCAUCGACGGGGUGGACGGCGUGAAGGGGGAGA	GUUCGGAACCCACACCCUCC	-21.70
GCCAAGUGGAGAAGGGUUCCUAUCCCUGGCAGGUAUCUCUGAAACAAAGG	UCAGGUUUCCCUUCGUGAAA	-18.50
UGACAGGUUGAAUAGAGAGCUGUCUCAGAAAACUCCUCCAAGUAUGCGGU	GGUCUCCUUUCGGUCGGGGA	-15.80
GUGGAUUUAAAGUCCUUGCCCCUCAGAUCAGCUUUGCUCCUGAAAUUGCA	UUCUCUGGCCAAGUGACACU	-11.90
GAGGAGUCAUCGGACAGUGCGGACAGUGAGGAGGCACCAGCAGCCAUGAC	GUCUUGAAUCGGUGACACUU	-15.90
CCUAUGCCCAGGGAAUAAGAUGUAUUCUUUAUAAUUGAAUUGGUUUUUCC	CCGACGUUGUGUUCUGUGCU	-7.70
UGACCACGGGUCUGCUUUUCUCUCUGAUCCUAGGGGACUUGUUGACAUGG	ACUCCGACACCCCGACCUCA	-14.40
GGCAGGAGAGGGAGAAAAACGGCAAUGAGGAAGGUGAAGAAAGAAUGACC	GACGUGGCGCAGGGCAGGGA	-6.20
AACAAUAUCCCUCACACCCAGCAACAGUAACACCCCUCUUAAACAUUCUG	UUCCGGUGUAGGUCGUGGCA	-16.10
GGACAGUGUGGUGGCCGGCUUCCAGUGGGCCACCAAGGAGGGCGCACUGU	ACCCACCUCUUCCACCACUU	-28.80
AGAGCUGAUGCGGGGUGGGGAGCUGCUGGACAAGAUCCUGCGGCAGAAGU	AAUUCCAAUCCCAGAGUCCC	-25.50
CAAAAUGCCCUGGCAGAGAUAACUUGGGAAAGAUUUUAAUAUAAAACUUG	GUUCAAGCCUAGAUGCCCAA	-8.10
CCUGAGCCAGCAGCAGAAAUGCCAGACGUGAAAGCUGAAGAUGAAGUGGA	CCGUCCGUACGCCCGUCUGU	-18.00
CGGCCAGGAGAUACAACCAGCACUUUCUGUGGUACUCCUAAUUACAUUGC	GCCCCGUCGAGUCAUGUCCU	-13.80
CAGUGCUGCAGGGCCGGGCCGACUCCAUCCUCGCCUACCACCAGCAGAAC	GUGGCUGUCGUUACUUACAA	-17.90
AAGGCUGGAGUACAGUGGUGCAAUCUCAGCUCACUGCAGCCUCCUCCCGG	AUCUCACGUCUGGUCCCAGA	-20.40
GCUCUCAUAUUUGGACAGCUCCUAACUUCUAGUAACUAUGAUGAUGAUGA	GACCCCUUUUCCCACCGUGC	-4.40
UGCGGGAGGGGGCGGGUGGGGAAGGAUCGCAGGCGAGAUUACGAGGCGAG	CUUCCGUCAUCCAACAUAUC	-21.30
GGAAGCGCUGAGGAUCAGGAAGGGGGCACUGAGUGUCCGUGGGGGAAUCC	UGGGGACCUCUAAGACUAUU	-21.10
ACAGAGGGCCAGCAGAACGAGCAGUGACAAGACAGGUGGGGCCUGGCUCC	CCAUGGUCCUCACCCCA	-18.60
CUCCACCAAGUACCGCUACUGAGGCGCCCUCAGUCUGCGCGGAUAAAUGU	AUGUCGAUCUAUUGGUUUCU	-19.90
CCGACCCCGACGUGCUGCACAACAGCUAUGCAUUGCAUGGCAUCCGCUAC	GGGUUAAUUACAGACAACUA	-19.40
CAUAGAUUUGCAGCUCAGUAGUAUAUGGUGUUCCUAGAAUGCAGCUGAAG	UCACGAACGAUCCACGGUUC	-14.10
AGAGAGCCUCUCUCCCCACCCCAAUCUAAAUAUGGAAUUUGGUAAAUUAG	CUCUCACAUCCUACAAAUGU	-10.00
AACCGACCUCAGGGCCAGUCCACGCAGCCUAGCAAUGCCGCGGGAACUAA	GUCGGGGAGGUCCCGAAGGA	-26.70
CAUUGCGGGCAGUGCUGGACGUGUCCCGGAGACCCACCGGGAGGGCGCCG	UUCCGGUGUAGGUCGUGGCA	-28.70
UGAGGAAGAACCAGGCUUGGGGGACUCAGGCAUUCAGUCAACACCAGGCU	UUCGAACGGUGACUUCUUGA	-21.60
GGGAGCGGGUGCGCGUGCGGGAUAUUAACGAGGCCUUCCGGGAGCUGGGG	CACCUCGGGACUCUUGGCCU	-29.90
GAUAAGAAGGGACAAGGUGCUUCUAGCCCUGUCUCAGUCCGUUAUCACUC	GUGGCUGUCGUUACUUACAA	-15.50
UAUCCAGAAAUAGAAAAAUUCUUUCCCUUCAAUCCUCUAGACUUUGAGAG	UCGUUUGUAGACUGACUUUC	-10.00
UCUUGGGCUCAGGGACUGGCUUUCGGCCUAUUGGUGGUGGAGCUGGGGGU	GGUUAUAAAUGCACGACGAU	-18.00
UCUAGAUGUUCUGAAGUACCUGAUACAUGUUAAAAUUAGAGGUAGUAAAA	CCUCAAGAACCGUACCCUCC	-10.30
AAGGAGAUCAUGGAGCACAUCAGAAAAAUCUUGGGGAAGAAUGAGGAAAC	GGUAUGUUGGAUGAUGGAGU	-8.60
AUGGGGAUGAAGGCCUGGAGCUCAUGAGCCCUAUUGUAACCAUCAGCAGA	UCAUUUGUCGGAAGAGGGUC	-14.50
AAGAGGAGGAGCAGAGAAGGGCAGAAGAACAAAUGCUAAAAGAGCGGGAA	GGGUAAGGUGUUCGGGACUA	-8.50
ACCAGUGGGAGGACCGGAUCCAGGUGUGGCAUGCGGAACACCGUGGGAUG	UGUUUAGAGGUCUGGUGGGU	-18.60
CGGUGGUGUGGGGGAUGUGCUAAGAAGGCCAUCGAAAGAUGAGCCCUUGU	UAGGGACCCUGGUAUGGAUC	-22.00
UACCCAUACGCCGCCUCGCCUGCCACGGCUGCCAGCUUCGUGGGCUACAG	CACGGACUCCCUCAUUCUGU	-17.10
CCAAGCUCUCAACUUCGCCUUCAAGGACAAGUACAAGCAGCUCUUCUUAG	UCAUUUGUUGGGAGAGGGUC	-20.20
UGUUGGUGUAGCACAGAAGAAAGACCUGUGUCCUAGAGAGUAGGCCAAGG	GUAGAGUGACAUCGGAGUUU	-19.40
GAAACUUCGGUCUCAGUUGGAGUUAUUAAUUAGCCCAACCUGUUCUUGCA	AGUGGCUGUCCAACUUACAA	-12.50
UUCCCCAGUACAUCCACAACAUGCUGUCCACAUCUCGUUCUCGGUUUAUC	CGUAUCCUACUGUUUCCCUU	-3.80
AGGACUACCAGCCUGGGAUCACUUAUAUUGUGGUGCAGAAACGCCAUCAC	ACUCAAGAUGGUAACGGUUU	-20.50
GUUCGCCGUCUGGCGAGCCCUUAGCCUUGCUGUAGAGACUUCCGUCACCC	GUUCAAGACAGUACGUGACU	-19.20
CAGCACCGGGGCAAGUGAGAGCCGGACGGGCACUGGGCGACUCUGUGCCU	CUGAUAUCUUGAAAGGGGGA	-20.10
UUCGGGGGCCUUGGGAGAGUUUAAGGCACCUGCUGGUUCCAGGACCUCGC	GUCUUGAAUCGGUGACACUU	-20.00
AAAACCAUCUCUGUGAUUACCUCUCAAUCUAUUUGUUUUUAAAGAAAUCC	CCGUCACCUCAAUCACUAAC	-6.10
UUUGUUGUUUUUAGAUACUAAAUCGUCCCUUCUCCAGUCCUGAUUACUGU	GUUAUCUGACACUCGAGGAA	-6.90
CACUCUCCUCCGCCAUGCCCGACCCGGCUAAAUCUGCUCCUGCCCCCAAA	AUCACGUUGAUACGUUUUGA	-9.40
AUGAAAUAGCUUCCAGGAGCUCCAGCUAUAAGCUUGGAAGUGUCUGUGUG	GCCCCGUCGAGUCAUGUCCU	-18.10
ACAAUAGCGAGGGGAAGCGGCUUAACACCCGAGAGUUCCGCACCCGCAAA	GGUUAUAAAGACACGACGAU	-14.10
GAAGAUGUUCGUCAGCCAAUUCAACCUCCAGCCAGCUUCUUGAGCCUAUU	UACCACGAACUGCCUUGGUA	-11.30
UGGAGGAGGUCAGAGAGGCGGCAGCCAAGACUUUCGAGCAGCUGCAUUCC	GGGUUAAUUACAGACAACUA	-13.70
ACAAUAGCGAGGGGAAGCGGCUUAACACCCGAGAGUUCCGCACCCGCAAA	ACAGAGGUGUCCCGAGAAAU	-15.70
UGGUGGAAGUCUUGGGUGUUAGUGUCAGCCAUGGGAAAUGAGCCAGCCCA	CAGACCCUCUGUCUCCUUGU	-14.70
CGCCUAAGCCUUCUGCCUCACCCAAGCCCUCUCUGUCAGCUAAGCCUUCA	UUCCGGUGUAGGUCGUGGCA	-15.70
CCUCUUCGGGGGAUGGAGAAGUUUAUGUUUGGGAUGUGAACUCAAGGAAG	GCCCUGAAACUCCCGGUCAA	-16.90
AGGAAUUUGGUUUACUGCUUUGUAAAUAAAAGGAAAAACUCCGGGUAUAU	CUUCCUCGUGAAUCCCGUCA	-19.00
GACAUGAUGGGCCACGGAUCUGACUACUCACUCAGUGAAGUGCUGUGGGU	UUUCUGUCAUCUAACAUAUC	-17.20
AGACUUGGAGGGAGAAAAUAUUGAAAUUGUUUUUGCCAAGCCACCAGAUC	CGGUUCAUUACCUCUUGUCC	-13.00
AGUGACUGGGCCAACACUUUCUCAUAAAAAUUGGCCUUUUACAUGUUGUC	CGGGAGAGUUGGGUCGAAAA	-13.40
CUGACUGACAACUGCCUUUACUACUUUGAGUAUACCACGGAUAAGGAGCC	CUUCCUCGUGAAUCCCGUCA	-13.70
CCCCUGCCUACCUCCUUCCUCUCUUUUUCAUUCUCUGUCAUGCUUCUCCA	UGCCCUCACUAGCACAGUAA	-7.40
AAUAAUGGUUGUGGAUUUUGAAACAAAGCAAGGUAAAGCCUUUUUUUUUU	GCCCUCCCCUGACUCGGACU	-12.60
GGAUCAAGCAAGGAAGCGGGAACACCACUGUGACUCGAGGGAACGAGACC	UCGAUCUAACAUUCGAGGAA	-12.80
ACAAGGGGACGGGGUCUGUGAGAGUCAAUUCAGGGGAAAGAUACAAGAUU	CACCUCGGGACUCUUGGCCU	-18.50
UUCACCUCUGAUCUCAGCUUCCCCACCUGUGGAGUGGGUUUAGUGACCUG	AUGUUAGUUGCCAGCUACCA	-12.10
AGAUCUAUGAGGCAGGAGCUGGGGACAGGAUGGCAGGAGCGCCCAUGGCU	ACCCUGAAACAUCCGGUCAA	-18.70
UUUGACCCAGAAAUAGAAAUGGAAGCAGAGAGAGUGGCCAAGAGGAAGUG	CCUUCACGAUCGAGUCGUCA	-13.70
AGAAUGAGAACAUAUGGAGCCAACUUGAGUUCGGAAGGGCUGUGGCCACC	ACGUGGUCGGACGGACGACU	-14.80
CUUCUCUACUGUGCAUACCCAUGAAAUUUAAUACACAUUUUAAAACCUCU	AGACGGCCUUGGGCAAGGGU	-11.90
ACCAUGUCGGCCAGAUGGUCUCAAUCUCCUGAACUCAUGAUCCACCUGCC	UGUUCAAUCCCAGAGUCCCU	-12.40
GACAGUGCCAGAGAGGAGCAGCUUCUAUGACAGGAGAGUAGUUAUAGACC	CGGCACUGACCUCUGACAAU	-20.50
UCAAUAAGGGUCUUCAGGCUGCCCAGAAAGAGGCUCAAAUUAAAGUACUG	AACUGUUAUAGUAACGUGAC	-14.60
GAGCUGGGGCCGAUGAAGAUGACAAGGGGCCUAGGGCACCCCGCCCACCU	AGAUCCUAUCCGGGUCCCCG	-26.00
AAGGGACGGCCUGCUGUUAGAAGGACCCUGGACUCCUUAAAGGGGUGGCC	GUUAUCUGACACUCGAGGAA	-20.00
CCACGUGGUUCCCUGCUUUGACGCAUCCAAAGUCAAGUGCUCAGGCCCCG	AGGUCAGCUCCUACAAAUGU	-14.20
CCACCUCCUGGGUUCAAGCAGUUCUCCUGCCUCAGCCUCCCGAGUAGCUG	UGUAUGAAGAAAUGUAAGGU	-13.30
CACAUUCUACUCAGGCUGUUGCUGUCAUGGUUGCCACCAGAGAAGGAUCU	AUUUGGUACUACACGACGAU	-13.30
AACUCACUGUCUGCAGCUGCCUGUCUGGUGUCUGUCUUUGGUGUCAGAAC	UCUGUGUAAACCUCUCCCUG	-12.40
CUUAAGCCACUGCCUCUCCCUCUGGUCCCACAAAUGGGCGCCCCCCCCUC	CGUCUUCGUAAAGGCGUGUG	-15.00
GAAUUAAGUGAGCAGCAGGUGGUUCACUUGAGCAAACUGCCCAUUAAGUC	AUCGGGACAUGUUACGACGA	-19.90
CAUUUGUCCCUGGUGCUGCUUUUAAGGAUGUAGGGCCAUGUGAUCAGGUA	CCUUGGCCGUAAACAAGACU	-16.90
CAUCUUGUCCUCACAGCCCAGAGCAUGUUCCAGAUCCCAGAGUUUGAGCC	GGGGUGACCCGGCAUGGGUG	-17.60
GAAGAGAAACCAGAAGGAGGACUUAUAAUUGGCUAUAAUUUAUAAGAAUG	UGAAAAACCCCAUUCCCGAA	-8.00
AUUCGGUCUUCCAGCAGGGGAUGAAGAACAAGAUCUUGAUAUUUGGCCUC	CGGGAAAAUUGUAACGUGAC	-10.80
GCCGUGACGGGUGACGGGGUGAACGACUCCCCUGCAUUGAAGAAGGCUGA	GUUUUCAUUAACACCAAAAA	-16.90
AGCAAGAUGGGCAUGGAGGCGGUGAUGGCGCUGCUGGAAGCCACGCCUGA	CUCGUCGUUUAUUACUAAGC	-22.20
CCUUGGGGACCUGCCAAACGAAAUCCCACACCUGUACAGAACUGGGAUAG	CGAAAAACCCCAUUCCCGAA	-17.50
AAGCCCAGCCCUGGGGAGCGCCCCAGCUUGUCCCAACAUCGGCGCCAUCA	ACCCUCCUCCCUCUUCUCCU	-15.10
GUCAGAUGGCUAUGGGAGGUGCUAUGGGCAUAAACAACAGAGGUGCCAUG	CGGUAAUGAAAACGUGGUCG	-18.20
UCCCCUUCCUUUGUCCUAAUCCUGGAAUUAAGUACAGGGGUUUAUAGGUU	UAGUAAUGGUCCGUCAUAAU	-15.40
AUACGACUCAGCCCAGCACUCUCUGCCCCAGGACUCAUGGCUCUGCUGUG	GAUACGUUGGAUGAUGGAGA	-16.70
ACCACCAGAGCCAGAAUCUUCAAUUACGUUAACACCUGUAGAGUCUGCAG	ACCGUCUGACACUAAACAAC	-8.60
UUCCUGCACUGCAGAUGGCUUUCAAACUGGGCCUGAGCUAUACCCCCUUG	UCGUUCAUGGGUGUCACGCC	-18.30
AGUGUCCCCAUGGGCUCCCACUGCAGCCUCGAGUGCCCCUGUCCCACCUG	GCCCUGAAACUCCCGGUCAA	-14.30
UCAGAUCGUCAUCAACCGGGACGACGUGCAGGGCUACGCGGCCAAGACUG	GGCCAUCAGGGUCCGGUCA	-19.60
UUUAGCUCUGAAGAUUCCUUAGGUAUCCCUGAAGACAGCUCGCUCAGAUG	GUCCGAGGUCGAAGGUCCGA	-18.90
AGAAGCAGAAGCCCCAGGCUGAGCGGAAGGAGGAGAAAAAGGCGGCUGCC	GCUUCGAGGUUCCAAGGAGG	-18.40
CACCGAGGACAGUGCAGGGGUGCAGACUGAGUUCUAGGCCAGUGGGUCCC	ACCCUGAAACAUCCGGUCAA	-23.90
GUUUGAAUUCUCAGGCAUGGUUUGGCAGUGCAAGAAUUCUGUAACAUUAA	UCAGGUUUCCCUUCGUGAAA	-13.00
AGGAUGGAUGGUGGAAGGUGGGGACGUUGGUGGCUGGCUGAGGUGCAUGG	GGCCAUCAGGGUCCGGUCA	-20.60
CCCUGGCCAGCUCUUCGCCCCUCACCUCUUUGAAACUCUGGACGUAUUUA	UUUUCGUUGACUCCAAGAAC	-7.10
CUCACUCGGAUCCAGUCUCGGCCGUUCAUUUUAAUCGUGAUGGAUCCUUG	AAGUCCUUGUAUAACGUUUU	-14.10
AAUAUUUCAGAGACAGCAACUAGCAGUCUGGGAACACUGGGUUGGAGCUA	AGGUCAGUUCCUACAAAUGU	-13.50
UGUACCCUGAGCCCCCGCGCCGCACGCCGGUGCAGCCCAAUCCCAUCGUC	UGUGUUAUUUACAAACGACU	-14.00
UCUUAGGAAAAUUAAAUCCAGACCCUCACUUCCAGGGUUUCCAGAAGUUG	UUGUAGUCAGACUAUUCGAU	-13.10
CACAGGCCCAGGAGGAUGCCAUGUCCUGGUCCAGCCAGCAGGACACCCUG	ACGUGGUCGGACGGACGACU	-26.70
GGGAGAGGUAGAAGAGAAGAAACAUAAAGAAGACAAAGAUGAUAGGCGGC	UCAAGAAGUUGACCGUCGAA	-12.10
CAGUGCCCGGUGUGCCAGCAGCGCUUCAAGCGCAAGGACCGCAUGAGCUA	CCCCCCGCUCCGUCCACACU	-18.70
GUCAUUGGAGGCAAUGUGGUCACUGCUGCCCAGGCCAAGAACCUCAUUGA	GCAUAGGCGUGUUUCGGAGA	-18.30
UCCCCUGGCUUCCACUGUGAAUGGCAGAAUAGUUACACACACUGUGGGCC	GAGCUUGGUGACUAGGUCGU	-17.20
GGGAACAGCCCGGCUCUCGCUUCAAGCCACCCUGUUCCCAUCCAGAACCC	GGAAGAUGUUUAAGUGGGUA	-24.10
CAUGCUUCGGAUCUACAUUGCAUUUCAAGACUACCUAUUUGAAGUGAUGC	GUCCUCGAGUGUUAGAUCAC	-17.40
CAUAUGUUAGCAUGGCAGCAUUUUCAGAUAGCUUUUUGUUUGUUGGGAAG	CCAGGAUGUGAGUUCCGUAC	-13.50
CCUGAGGUGCUGGCCAGUGCACCCCCACUCCCACCCUCAACCGCGGCCCC	GAGUCUUGGGUCUCCAGAGU	-19.70
AUCUGAGAACGGAGUCGUUGGGGGUGGUGGAGGGGGUUGGAAUUGGGGAC	UGACGUGAUCGGACCGACUU	-16.20
GAGGGAGGCGAAAAACAGGGGAAGCCUAUGUGCAAUUUGAAGAACCAGAA	GGGUUAAUUACAGACAACUA	-8.20
AGAAUGCAGACCGGGAUGAGGAUAAGGCAAAGGCCUAUGAAUUGGAGCAG	UAACGUUGGCUAGGGUUGGA	-15.60
CCACAAUAAUCCCUUUGAUCACGUUAAUCUAAAUCUAGAUGUCUUUGUCU	UGACUAAAGUUUACCACGAU	-4.80
AAGGCUGUGGUCCAAGGCCAUUUUUGCUGGCUAUAAGCGGGGUCUCCGGA	CGUUUGGGACGUACACCCUC	-20.30
AGGAGAGGAUCCGGCGCCGAAUCACUGACUGGCACAGGUGUUGGGAAAAU	GGUGAGUUGCCAGCUACCAA	-16.60
CUUCGAGAUGGUCCAAGGUUGGCAUCGGAAAGCCACCUCCUGUGGCUUCU	GGGUUUUCCUCUUAAGAAAC	-17.30
AAGACCAUUGGGGGAGGAGAUGAUUCCUUCAACACCUUCUUCAGUGAAAC	UGUUUUAGUGAUCAGAAGGU	-17.90
UCCUAAACUCCCCAACCCACCUCUCUUCCCUCCGGACUCUAAACAGGAAC	AUGUUAGUUGCCAGCUACCA	-5.50
AAGUUCCAAUACCCUGCUACCUGAUUGCUUUAGUUGUUGGAGCUUUAGAA	CACUCGUGGGCCGGGGACGC	-25.20
AACAAUGGGGCCGGGGCGGUGGGGAGAGGCCGAGGCUUGAGGUAGGCAGC	GAGGGUUCUUGGAGUGGACA	-15.70
GUACGGGACAUUUUGCAUGCCACGUUUGAAGAGUCUUUGGAUAAAACAUC	CGGUUCAUUACCUCUUGUCC	-12.60
GAGGAGAUCGGGCAGUUGGUGAAGCAGAUGCUGGAUGACUUUGGACCACA	GUUCGGAACCCACACCCUCC	-18.30
ACUGCUGAUGAUACCAGUGCUGCUGUAACUGAAGAAAUGCCACCCCUUGA	UCAUUUGUCGGAAGAGGGUC	-13.60
ACCUAUUACCUAUUAUUUGCUGUUCUUGCAUGGUUCAAACCACCAUUCUG	ACCUCCUGCCGUUGUCAGUC	-6.00
AAUCUGGGGAUGAAGGGUCUGAAGAUGAAGCCCCUUCUGGGGAGGAUUAA	CUUAACGCAAACCUGUUAGU	-19.50
AAUGGGUGAAAAUGGAAUUCUUCCUCCUUUUUUCCAAUGUGCUUGAUGUC	UGUUCACGGAAGUGACGUCA	-16.50
GCAGUUUGGGGCUCUGGAAUUUGGGUCAGAACCUUCUCUCUCUGAAUUUG	UCCCGUCCGUGGCCGUGAGU	-21.50
ACCCAUGUGAGGGAAUAAACCUGGCACUAGGUCUUGUGGUUUGUCUGCCU	GACGUCCGGCACACGAAACG	-26.40
CAGUGAGGCUGAAGUAAAGGGGCAAGAUAGGGCAGUUAACUAAAGAGCAC	ACCGCGGGCUUGUCCCU	-19.10
ACUUCCGAUCUGAAUGAAGAGCUUGGACAGGUAGAGUACGUGUUUACAGA	GUCUUGACAAGGGCGACGAU	-14.20
CCCUGGGGGCGCUGUUCCACAGUGACUGGGCCCUGUCCAGGGCAGUGAGU	AGGGGUGUCUGGGUCUCGGC	-29.50
AACCAAAAAGCUGCUGGAUAACAUUUGUCAUUCAUAUUCUUUGCAAGCAU	CCUCUGUGCACGUGACAUCU	-7.90
GAUUCUCCGGGCCCAAAGCCGAAGUGCAAGUGGAAGGAAGAUCUCUGAAA	UUGUUCAUUAGUUCUUAUCC	-14.90
CCUGUGUCCACCUUUCUCUCCUCUUCCCAAGCCUUUUUCCUACUACCUUU	CUUCCGUUAUCUAACAUAUC	-3.10
AUUGGGCAGAAGGGUGAACGGAUCCGUGAAAUUCGUGACAAAUUCCCAGA	GCGAUCGUUAUGUGACGGAU	-12.50
AACCACCAAAUGGCUCAGGAAGAUGCUCAGCGUCUCUAUCAAGCUGGUGA	GGUUAUAAAGACACGACGAU	-15.10
GACUUGCGCAGUGAGCAGCCGUGCUUCAAAAGUGACCACGGACGCAGGUU	UGGUUCUUUAUCGGAAAGUU	-15.60
UACAGCACAGGCUACGGGGGCUACGAGGAGUACAGUGGCCUCAGUGAUGG	GCUUCGAGGUUCCAAGGAGG	-20.80
AAUGCUUUGAGGGGGUCUGUGCCUGAAGCUCAGGAGUGUGGAUCAGACAG	AAUUCACGAGUAUUACGUCA	-18.70
GCUUUGCCUCCUACCAUCUACCUAUAUACCUUAUUGUAAUGAAUGUUCCA	UGUGGAUCCAAGGUUCCUAA	-10.40
GUAAAGCUCCUCGGCCUCGGCGUGCUGCGCCUCCGCGGCUGCCCUGCGCC	GCCCCUGCUUGCCCUGCCCA	-20.70
ACACGCUGCGGGCAGUGGAGCUGCUCUACUCCAUCUUCUGCCUGGACAUG	GCACAGGGGUCACGGCACGU	-22.60
CACUGAGCAGCAUGGGGCACGCUAUGCCUGUCGAAUUCACCAUCCCAGCC	GUUGUUAUAGGACCACGACU	-13.80
UUGAACGGGUGCAGCGGGAAAAGGCUAAUGGCACAACUGUCCACGUAGGC	UAGGGUAGGGGUCCUUGGGG	-18.50
GCAAGAAGGAGAACGGGAUGCCCAUGGACAUUGUCAAUACCUCUGGCCGC	CCUUCCCGUCUCUCCCGGUC	-17.30
CAGAAUUAAAUUUUGCCUGCACACCUAAACACUGACAACAUUUAGCUUAA	GUUCUGGGGCCUCUAGGGUC	-8.80
CAGUAUCAACUCGAGGGAGGUUCAUGACAACUGAGGAAAAAGCCAAAGUG	UCGUAGUCACUAAAACAACU	-13.50
AAUGCCCCAAAAUCCAAACCUUCCUGAACGCUAUGACACCAUGAGUGGAA	GCCCCGUCGAGUCAUGUCCU	-6.70
UUAAAAGUGUACAAGUUGCUUUGUUACAAUAAAACUAAAUGUGUACACAA	AUGUCAGUUGCCAGUCACCA	-9.20
CAUCGAACUGACUGGCUUUGAUGAUAAGAUACUAGAAGAAGAUCACAAAG	UGGGAGAGUUGGGUCGAAAA	-10.10
UCUCACCAGUGCCUGGGUUCCAGCCCCAAGACGAGAGUCUGGUGUAUUUG	ACCCUGAAACAUCCGGUCAA	-16.50
ACGACAUCCAGCCACCUCCUCAGUCUCUGCCAUCCACAGGAGGAAGCAGC	CCGCCGUCCGUGUCCUGACC	-13.50
AAUGGAAAAAAUUGUGACCAGAGACGUGUAGCAAUGAACAAGGAACAUCA	GAUAUGUUGGAUGAUGGAGU	-7.20
CAUCUGCAUCGCCCAGGGCAUCUACACCUCCGUGCUCAUGUUCUUCAUUC	UACCCCACUACACUCGGG	-16.00
AUUACUUGGGGCACACAGCAAAAAAUGCUGUGAUCACAGUCCCAGCUUAU	GGGUAAGGUGUUCGGGACUA	-21.00
UGAUCUGGAAGUGUGCUAGUAUGCUCCCUAGUGGAUAACUUAAUCUUUUA	GGUAUGUUGGAUGAUGGAGU	-13.00
UUCCCUAAGGCCCUCUCCCUCUCAAAUAAUUAUUUGGAAUUUUGUGUUUG	UCCAAUUUCCCAGAGUCCCU	-9.10
GAGAUUGCUCGGAUCUACAAAACAGAUAGAGAAAAGUACAACAGAAUAGC	GAUAUGUUAGAUGAUGGAGU	-10.00
GUUUGGUGUACAGUGGCAUGGGCCCCGAUUACAGAGUGCUUGUGCACAGA	CAUCGCCUUCGCCAUUGACC	-18.60
GGCCCUGUGGCACAACCCUACCUUUGGUGGAAAAAGCACAUGACAGCCAU	GUCUCUCAGUCUCGCGCCUA	-11.50
AAAGAACGGGGAGAUUCCAAGGGCUCCAGGGAAUCCAGUGGAUCAAGAAA	AGGUAAGGGGUCCUGAGGUG	-23.60
UGCAGUAACUGCCAGUGUUUGCCUCACCAAAUUUAAAUCGUUCCCUUUUC	CUUCCGUUAUCUAACAUAUC	-6.90
GGGCCCGGGACUACUGCACCAGCGCCAAACACGUCAUCAACAUGUGCCUC	GUUCCGUCACCGGACAUGUC	-15.70
AUCAGAACCCGGGUCAAGUGCUUCUUUUGGCAAAAGGAGAAAAGAACGGU	CGACCAACUUCCCCUGGUUU	-13.30
CAUGGGAGGGAGGACAGGGAAGGCCAGGCUUGCUCUGGGACUUUUAUGCU	AGGUUGUCCCGGCGCAGAGG	-17.40
CAUAGAGGAGAUUGCUGGUGUUGGUGUCCCAGAACUGAUCAACUCUCCUA	CGAUACGGUCGUAGAACGGA	-15.40
GUUUCAAGUUGGGAGGAGGGUUGGAGAUACAAAAAUCACUCUGCUCUACA	UCCGACCCCUAUUUACUUAU	-16.30
AGCGUGAGGUGUGGGUGUUCGUUUCUCAGGUAAAACAUGGCUAAAAGCUU	UUUCGCACCCCCUUUGUGCC	-21.80
AUGAGAAUGGGGAGGAAGAGGAGGAGGAAGCCGAGUUUGGCGAGGAGGAU	UCGGCGCUCCUCGGCUCUCU	-20.50
UCAUCAAAAAGGACACCAGCAAGCUGUUCAAUGAGGAGCGGUUGAUCGAC	GUUUCUGGCGUUAAUGAAAA	-16.80
CAGAUCCAGCGCCUCGCCCAGGGCCUCCUGCUGGGACACCACCACCCACG	UACCACCGUCACCACCCUA	-13.70
CGAAUAGUGGCAGAUACCGGGACACGGUGCUGCUGCCGCAGACGAGCUUC	GUCCUCGAGUGUUAGAUCAC	-28.30
UCACAGGUGCUGGAGGGCGAGGCUGUGGGCAUCAAGAGCUUCGGCUACUC	CCUCUCUGUUCCCCUUCUCC	-22.90
GAAACGGACAAGAGGCCUGGGUGCAACGACCAAAAUUACCACAUCCCACC	CAAAACGUAUCUAAACGUGU	-8.20
ACAGUUGGAAGGGGAGGUGGAUCAUGCCAUGGAGCUGAGCGAGUUGGCUC	UUUAAGCCUAGAUGUCCCAU	-19.30
AUACUUCCAGGCUUUGGUGAAUAAUAUGUCCUUUGUAAGAUAUAAAGAAG	UGUAUGAAGAAAUGUAAGGU	-11.20
GAGGAGAGUGCUUGGGGCUUGAACCCCUUACCCCACUGCUGCUGACUGGG	ACCCACACACGUACUCGCAC	-19.40
CCUGGGGUUGCAGCUCCCCCAGAAGUAGCACCUGCUCCCAAAUCAUGGGC	ACCCACACACGUACUCGCAC	-21.70
CGGGGAGCUGGGUCAGCUGAGGACGUAUUUCCAGACAGCUAUGUAUCCAC	GCACCAAGAUGGGACACCAU	-17.30
GCAGGCGCUGCGCACCCGGUAUGGCGUGAGUCCCGAGAACAUUAUCCUCU	AGGGUCACGCCCUGGGGAGG	-25.20
UUCUGGCCCUGCAGCAUGCAAGCACUUUUAAAGAGCAUUUAGGUAAUACC	GAUAUGUUAGAUGAUGGAGU	-8.10
GCGACAGGAUGGGAAAGAAAAAGCCCUAAUUAAGGAUCGUCAGAAACCAC	GGGGGUGGUGGUGCGGGC	-12.90
GCAGGAGGAGCUGUCCCAGGCCAAAUGCAGCUCCGAGGAAGCACAGCUGG	GUACCAAUCUAGUUCGUGUU	-24.40
ACAUGGCUGAGCUGGGCAUGUGCUGAGGUUGACUUAGGGAACAAGCCCUG	UGACGUGAUCGGACCGACUU	-28.10
CGGGAGGCUGGGACUUUCCAUUACAAAUAGAGACUUCAUUCCUGUUGAGU	CUUUAGGGACCGUUACACUA	-14.40
UCUCGACCGGACCUCGACCGGCUCGUCUGUGUUGCCAAUCGACUCGGCGU	UUUUUACACGAUCACGGUUU	-21.00
UUUAUACCUUAUACCCAAAACACUUACUACCAACACAGCUGUUAAACAUU	CAAGAGGGUUGCAUUUGGGU	-8.90
CUGGGACAGACAGUUUUACUUCACGCAGGGUGGAAAUUUAAUGAGUCAGG	CUUAACGCAAACCUGUUAGU	-14.30
AGAAGAACUUGAAACCGUGUGAAGGAAUCCGGAGCAGAUGAGAAGGGAGG	UCCGACCCCUAUUUACUUAU	-10.00
GCAUAUGGGGGCCUUAAGGAAUAACAGUGUGCGUGGUGGUGUGCAGGAGA	CUUAGGAACGGGUCCACGUA	-17.70
GUGUUGUGGGCAUCAAGGUAGACAAGGGCGUGGUCCCCCUGGCAGGGACA	UCUGCCCUCCUCUCCUCACU	-20.80
CCCAGGAGACCAAAGGGAGGGGCUCUGCCGCUUAGCAGAGAAGAAAGGGC	GUUAUGUUGAAUGAUGGAGU	-12.60
GUGGACCCUGGCAAGGACUGGGAGUGGGGGAAAGACGACAACGAUAACGC	UUUUCGUUGACUCCAAGAAC	-13.90
UCCCUGGGAAUCCCCGGUGGCCGGAUGGACUACGGGAUAUCCCAGAGGAA	AGGAGAGUUGGGUCGAAAA	-27.20
UGAGCCCUCCACCAUCGCCCGCUCUCUACCAACCACUGUCCCAGAGUCAC	UUAACGGGUUCAGAGGCGGA	-19.10
AAAAUCUUCAAUAGUUGUUAUUCUGUAGUUUCACUCUCAUGAGUGCAACU	ACCGUCUGACACUAAACAAC	-13.70
AUGAGAGCGAUGCCCGCCGACGCAUGAUCAGCAAGCAGUUCCACCACCAG	ACUUAAGAUGGUCACGGUAU	-13.90
AGUAAGCCUCACCUUUGCCUUCCAACUGCCAGAACAUGGAUUCCACUGAA	CCUCAAGAACCGUACCCUCC	-7.70
UUAAAUAGCUGGGACUACAGGCACGUGCUGCUACACCCUGCUAUUGUCUG	GAUUCUGUGUCCGGGUCUCU	-20.70
AUCCUCUGCACUGUUGAAUCACUGGACUUACUGAUCUUAGAUGACCACCC	CGGUUCAUUACCUCUUGUCC	-4.90
UUCUGGAGGACGACAAGGAAAACAGGUAUUGGAUAUUCAGGUCCUGGGGC	GGAAGAUGUUUAAGUGGGUA	-13.20
AGCAAGCCCAUCGGAGUGAGCAAACCUGUCACUAUUGGCAAACCUGUGGG	GUUGUUGUACUUUGAUGGAU	-13.80
CAAUACUAUUUGGCCAUAGAUGUAAAAACUACCAAAUAAAAGUGGAUUUU	UACCCCACUACACUCGGG	-8.60
UCUUUGGUAGAUCUGGCAGGGAAUGAGCGAGGCGCGGACACUUCCAGUGC	UCGUUCAUGGGUGUCACGCC	-22.30
GAUCGCCAGGCAGGAGUUUCUCUCGGUGACUACUAUCGCUGUCAUGUCUG	GGCCAUCAGGGUCCGGUCA	-20.10
GGUUGGGGGCACUAGGGGUUCAGAGCCUGGCAGAAUUGUCAGCUUUAGUC	CGGUAAUGAAAACGUGGUCG	-20.70
CACUAUUGUUUUGGCUGGAUUUGUAUUACACACAGUUUUAAAAAAAACAA	UACCACCGUCACCACCCUA	-9.40
CCAGGAAAUCUCCGGAGCCAACACCACCACCCCCAGGGGGUCUCCCCACC	GUUAUGUUGAAUGAUGGAGU	-17.70
CUAGGAGCAAUUGGGGCAAGAAGAGGACAGUGAUAUUUUAAAACAAAGUG	GAUACGUUGGAUGAUGGAGA	-7.30
GCACCGGGGGGAUGUGGCGAUUCUACACAGAAGAUUCACCUGGGCUCAAA	GUCUUGACAAGGGCGACGAU	-15.70
AGACUUUGUCUCCAGAGCAUUGCCUUUAUAAGCAGAUUGGCACCAACAGU	UGUGGUCCUCUUUAGCCAGU	-12.60
UCAAAGGUGCUGGGCGAGGCCAUGACUGGCAUCUCCCAAAAUGCCAAGAA	UUCGUCGUGUCAUUAUAACC	-17.80
GUGGAGCCUCCCUGCACAAGCAGCACUUUCUUUUGCCAUAGCAACAUGUG	GUCUCGUCUGCACCAAGAGU	-15.30
UCAGUCACCAUGAAGCUGCUGCUGCUGCACCCGGCCUUCCAGAGCUGCCU	AAUGUUAUGUUAGACUAUUC	-14.40
GAAGAUCUGACGGAAGAGGAAGAUGGCGGAAUCAUUCGCAGAAUACAGAC	UCGUUCAUGGGUGUCACGCC	-15.10
CCUCCACCCCAUUUGCUCGCAGUAUCCUAGAAUCUUUGUGCUCUCGCUGC	CCCCCCGCUCCGUCCACACU	-6.50
GUUAACUGAGGACAAGGCAGACGUGCAGUCCAUCAUCGGCCUGCAGCGCU	CUCUCACAUCCUACAAAUGU	-16.40
CAAGGAUGAGACAGGAGCCUAUCUGAUUGACAGGGACCCCACCUACUUUG	GUCGGGUAGCUGACCACAAC	-20.80
GCCGCCCUGGCCCGAGGGACCCCGCUACUGGCUGUGCGGAACCUCCGUCC	GGUUAUAAAGACACGACGAU	-22.20
GUGGGGAGGUGGAAAUGAUGAGCAGUAGCAUCAUUUCUCCCUGUUGGGUU	CCCCCCGCUCCGUCCACACU	-31.00
AGCCUGAACGUGGGUGCUUGUGUUUGACCUUUUCAGCCAUAUAUUGUACA	GGAAGAUGUUUAAGUGGGUA	-13.80
UGGAAUAUAAAUAUCACAAAGUUGUUUAACUAGACUGCGUGUUGUUUUUC	GAUCUGACACUCGAGGAGCU	-17.80
AGAAAGAAAACGCCCACUCCUGGAUCUUCACAUUGAACUCAAUGGCUACA	CGAAAAACCCCAUUCCCGAA	-8.10
UCGUGUACCCCAUCCGGUUGGUACGUGUCAACGAGGACACCAUGGAGCUG	UCCGUCACAGCACGACAGCU	-20.00
GCGCUCUCCACCACCCAACCCAAACCAUGAGAAUUUGCAACAGGGGAGGA	GAUAUGUUAGAUGAUGGAGU	-13.50
UCGUGAGGAGGGAGGAGAAAACCUGGACCAGGCACGGGAAGAUGCCCAGG	UAGAGCGGGAGUUUUGGGGC	-17.10
UCUACCAAAGAACACACUGCAUGUAAAAGAUGUAUUACAAUCUCAAAGCC	GUUUUUUAAGUGGAAACCCG	-9.80
UGCAAAUGGUCCCAUCAGCUGUGGAAUAAUGGCAACAGAAAGACUGGCUA	GUUGUUGUCCUUUGAUGGAU	-19.70
AGCUGGCCUGAGCUGCUGCGUUCUGGGUUGCAGGUGCCUUGCCCCCGACG	GAUUCUGUGUCCGGGUCUCU	-22.60
AAAGAGGGGAAUAUGAGCCGAGGAAAUAGCUUAUUUUUCCGGAAGGUCCC	CUGGACUCAUCGCGUUCCAC	-18.90
ACUGCUGAUGAUACCAGUGCUGCUGUAACUGAAGAAAUGCCACCCCUUGA	GUCUUGAAUCGGUGACACUU	-15.50
CUUUUUCUGUUGAGCACUUUAUGCAUUUUAGUCUAUUGCAUUUGAGAAUG	UGCCCUCACUAGCACAGUAA	-7.60
CCACUUCGAUGGUUGUGAUUAAUUUAAAAUCAAAAUAAAGGAAUUACUGA	UAACGUUGGCUAGGGUUGGA	-9.30
AGGAUAGUACCUACUCCCUCUAACCACCUCACCCCAUUCUUGAAUGACAU	GCACUGUACUACUAGGGGCU	-10.40
AAGAAAUCCUGACACCCAGUGGAUCACCAAACCAGUCCACAAGCACAGGG	GUUGUUGUCCUUUGAUGGAU	-15.70
UGAGCACCUAGGCGGAGGCGGCGCAGGCUUUUUGUAGUGAGGUUUGCGCC	CCGACGUUGUGUUCUGUGCU	-28.00
CUGCCCCACAGAAAACGUAGCAAAGAUCAACCGAGAGGUGCUGCAUUCCU	UUUCAAGACAUCACGUGACU	-12.80
GGUUGGUGGGGGUCUGGGCUAUGAGCUUUUGAGGGUCGCCUGGGACGCGG	UAGAUGUAACAUACGGUCCA	-20.00
UGUGGAAUUUCCUAUCUUGCAGCAUCCUGUAAAUAAACAUUCAAGUCCAC	UCCCCCUUUCAAGAUAUCAG	-11.00
UCUCCCUCAGGGGCAGGUGGUGGAGGGGCGCCCAGGGUCGUCUUUGUGUA	GUCUUGACAAGGGCGACGAU	-18.20
GCUGGCCAGCGGACUUCUGGAGUUAGCCUUUGCUUUUGGAGGACUGUGUG	UCUGUGUAAACCUCUCCCUG	-20.70
CCAUGCAAGCCCGAGGCUUCGGCUCGGAUCAGUCCGAGAAUGUCGACCGG	UUCGAACGGUGACUUCUUGA	-19.60
AGGCUAAACAAGUGUGGGGUGAUCAGCCCCAGAUUUGACGUGCAACUCAA	CUUAGGAACGGGUCCACGUA	-24.50
UGCCUCUGGUAGUCAACAGCCUUUUGAAAGCUAUUUCCAUCUAGUAUCAG	UUGUAGUCAGACUAUUCGAU	-13.30
GAUGCCCAGAUCUCAAAUGCUCUUAAUGCUCAGCAGUAUAAAGUCCUCAU	CGUUACGUUGUCGUUACGUG	-16.00
CACAAGGGGCACUCCCAGGGUUAACAAAUCAGUGAAGAUCCCACCAUACU	GCACAGGGGUCACGGCACGU	-12.40
ACUCUGGAGGGGAACUGCAGUAGUAAGUCCUGGCAGAAGAUCCAAGAACC	AAUUCCAAUCCCAGAGUCCC	-12.80
CUCGCUGGCGUUCUCCGGGGUGGUUGGCAUUGUGUCCUGGAAGCGGCCAU	GGGUAAGGUGUUCGGGACUA	-18.90
AACAAAGCCAGGGGGCCCAGAGGAGCAAUAGCCCUGGGCCACAAGCGUGG	GAGAAUGAGGGAGUCCGUGA	-23.80
GGUGAACUGAGCCAGCUGGCCAUAGAACACAAGAACAUAUUCCAGGAAAU	UCCCCCUUUCAAGAUAUCAG	-11.60
GAAGGAGGCCUCGGCCCGGCGAGAGAUAGGGGGAGGGGAGGCCGGCGCGG	UUCGAACGGUGACUUCUUGA	-22.90
CACACUCCUGCACUGUGCCUGUCACCCAGGAAUGUCUUUUUUAAUUAGAA	UUUAAGCCUAGAUGUCCCAU	-10.50
AGAUGUCUUCAUCACUUCUUCCACUGUGUGUUGACACUGUUUUCCUUACC	UGUGUUAUUUACAAACGACU	-11.50
UCAUAAAUGGAUCUGGGGGUUAGAGUGGAGGAAAUAAAAUCCUGAAGUGG	ACUCCUCUCUCCUCCACCCC	-19.90
GGCCCACGUCCGGAUGCUGGGGCUGGAUGAGCGUGAGAAGUCGCUGCAGA	UGUGGAUCCAAGGUUCCUAA	-18.30
GCUGUGGGUGUGGGUGGGAGUGUGUCUGCUGAGUAAGGAACACGAUUUUC	UGACGUGAUCUACGUGGAAU	-17.70
AAGCCGCACCUGGAGAAGCUGACCCUGGGCAUCACGCGCAUCCUAGAAUC	UGCCUUGGUGAUCACUGAAC	-15.60
CAGGUAUGUGGAGGGGACAAGCCUUACAUUGCACCUUCAGAUCUGGAGCG	UCGGCGCUCCUCGGCUCUCU	-20.50
CCGAGGAGCUGGGCAUGGACGACUUCACCGCCUCCAACGGCUGGCUGGAC	CUCCCUCUGGGUCCGAGCCU	-27.20
CAGCCUCUGCCAUGCAACUUUCAACGACCCUGUCAUGGCUCAACAACAUU	CCUUCCCGUCUCUCCCGGUC	-13.30
AAUUCUUUUAGGCAUGUGUUAGAUUUCUGUGUAAACUUUGUUUAAAUGUA	GGAUACCUUAAGUCAAGAGU	-8.40
CUGCAGGACUGCGGGAGCCAGCGCUCCUGCCGCCCCUCUUGCCCCUCAGA	GGGCCGGACACACCACGAGU	-24.80
AGGCUGUGGGGAGGGGGCUUCGCAGAUCCCCGAGAUGCCGGAGUUCCUGG	ACCCUCCCGUCACCACUCUC	-30.80
CUUCCUGAUGCCCUUCCCGGUGAAUUACGUGGGUGAAUGCAUCCGAACUG	GGGUUUUCCUCUUAAGAAAC	-15.30
GGUUAACAGGCAGUUGUUUACUUGUGGUUUUGCUGCACUAUUGCAAUUUC	UUUUUACACGAUCACGGUUU	-15.30
UUCUGUGGGAAGAAGGUGAAGGAGAAGCUAAGUAACUUCCUGCCUGACCU	GUCUUGAAUCGGUGACACUU	-16.30
CUAAGGGUACAUUCCUGCCUUCUCUUAGUUUGUCAUAUGACUAGAACAAG	UAGUUAUGAAGGACCGAGGG	-20.20
GGAGGAUGAGGAGAAAAAUGAAAGUGGGUUAACUGAAUACAGAUUAGUCU	GGGCCCGUCGUUCCGUUCCA	-12.00
UUUUAAACCUACUGUCUCUGUCAUAACUUGUCAACACUGCUGUAUGAAGC	GUCUCUCAGUCUCGCGCCUA	-5.90
CUGAUGACAUCAUGAAACACAUAGGGGAUGACGGAUCAAACUCUGUAGCA	GUUAUGUUGAAUGAUGGAGU	-9.90
UCCCCAGACCCACUCCAACCGCAUCUAUCGCAUGAUCAAGCUAGGUCUAG	ACCCUGAAACAUCCGGUCAA	-9.30
GCCAGUCCGUGGGGUUGGCGGGCCAUCCCAACAGGUGAUGACCCCACAAG	UGACGUCCGGGAUCUCCUGU	-28.20
CCCGUUCUACCAGCUACCUCCGAGCGUGCAGCGGCACUCCCCCAACCCGC	AGACGUGACAGUCGUGAAAU	-17.00
UUCUGGGUCAGCAAGUGGGUGGACUAUUCGGACAAGUACGGCCUUGGGUA	CCGUAAGUGGCGCACGGAAU	-17.10
ACUGCACUGAGCACUUUAUGAGCUUGAACUCUGUUAAUCCUCACGACCAC	UUUCGCACCCCCUUUGUGCC	-8.70
GAGCGCCGGGACGCCAAGCACUUCCUGCCGCGGGCGGCGCGCCGCAGCUG	GAGACAGCAGCUCCGCGAGU	-25.40
UUUGACCUGGGGCGGAAAAAGGCAAAAGUGGAUGAGUUUCCGCUUUGUGG	UAGAGCGGGCGUUUCUGGGU	-20.30
UUCUUGUUGGUGCACAGCACAAAUUAGUUAUAUAUGGGGAUGGUAGUUUU	GUUUUCAUUAACACCAAAAA	-8.80
CCACUGGUCGGGUGCUGUGUGGUGAUGCAGGCCUUCUGCGGGGCCUGGCU	GUGGGUCCAUCGUUCCUAAU	-23.60
UCCACUGUCUGGGGUUAGUGUUUUACAAGGUCAUUACACAGUCUUUUUGA	UCGUUUGUAGACUGACUUUC	-11.20
AUAAGUGUAGGAGUUUUAUGUUUACCAUGUGAGUCCUGCAACACUAAAGA	UGACGUGAUCUACGUGGAAU	-18.80
CUGGAAGGGAACUGGGCCUCGGUGGCCGGGGCCGCGAGCUGUGACCACAG	GAGGGUUCUUGGAGUGGACA	-25.20
GUUAAAGAAGUGUGGUGCCUGAUGUUAUAACAACACCUCAUUCUUAACUG	AUGUCAGUUGCCAGUCACCA	-11.30
AAAGCCUUACGUUCUGCCUAGCGUCCGCAAGGCAGAGGCCCAGAUUGCCG	UGAGGGUCCCACAUUGAGAU	-24.00
GCCAUUAAGAAGGAGCUGACCCAGAUAAAACAAAAAGUGGAUUCUCUCCU	GUUAUGUUGAAUGAUGGAGU	-10.90
CAUCUCGCUGCCUCUAUCCCGCAUCCGGGUCAUCAUGAAGAGCUCCCCCG	GUGGGUCCAUCGUUCCUAAU	-14.20
UUUUAGAGGGCCAUACCGAUUUCAUUAAUGGUUUGGUGUUUGAUCCCAAA	GUUUGGUGUCACACGACGAC	-13.90
UUGCUGAGAUCAGAAAGGACAUGAGUGGCCACUAUCAGAAUGCCCUAUAC	UUCGUCGUGUCAUUAUAACC	-10.20
UGAGAAGCAGAGGGACAAGGUGUCAUCCAAGAAUUCACUUGAGUCCUAUG	ACCCGAAUGCAACCCUCUUG	-15.30
UUUCUUGGAGCCUCUCCGAGCAGCAACCAGACGGGAGAUUUUUAUUUUAA	GCCCCUGCUUGCCCUGCCCA	-21.00
AAGCAAGGCCCGGGGAAGCAACAAGGUGAAAAUUCAGCCUGUCGCCAAGU	ACGUUUGUAGGCUGACUUUC	-18.00
UUGGCUCAGCAGCAGGCGGCAUUGCUGAUGCAGCAGGAGGAGCGUGCCAA	GAUACGUUGGAUGAUGGAGA	-20.10
CUCUUUGCCUCACUCUCUCCAGUUGGUUUUCAGCUGGGGCUUGAAAUGCA	GUGGCUGUUGUUACUUACAA	-17.50
GGAGAUUCCGUGGGUCCCUGUGACAUAUUGCAUUAAGAUCGUGGCACUUG	UCUGCACCUCUUUAAUCUUA	-13.90
UUCUGACCUCUGCCCUGGGGCUGGACUGCAUGGCCCCCCUCUUUCCCUCA	AUGUUAGUUGCCAGCUACCA	-12.40
GUAAAGUGACUGAGCUGGAAGACAAGUUUGAUUUACUAGUUGAUGCCAAU	GAGACAGCAGCUCCGCGAGU	-13.50
UAGCUUCCAGCCUAUCAGCUCCCUGCGAGAUGACGAGAGGCGGGAGUCAG	GUUCGGAACCCACACCCUCC	-19.50
GGUUGGGGAUGGGGCUGGGGUUGUGGCCCUUGAUCGCGUCUUUCACGUGG	GCCCCUGCUUGCCCUGCCCA	-29.20
AGGCCGGGAUCCGGAGCCGCCCGAAGCCGGUGCCGCAGCCCCCUGCGCCC	ACAGAGGUGUCCCGAGAAAU	-22.10
AGAGCCAGGCUUGGAUGGAACAUGCCCACAACUUGUCACCCAAAGCCUGU	GUUCACUUCGGACCCCCGAU	-17.90
GAGUGUGUUCCAUCUGGCCGUGUCAGUGCAAAUUGCAUUUCUUACAAAGG	UGUUUAGAGGUCUGGUGGGU	-15.10
AAGCUGCUCGUCCGGAAAUUCCUGCAGACUCAGGAUGACCGGCCUUUCUU	ACCUCCUGCCGUUGUCAGUC	-17.20
ACUAGCAGAUUUGGAUCCAGUAGUUGUGACAUUUUGGUAUCGGGCUCCAG	ACUCCGACACCCCGACCUCA	-14.10
UUAGGAAAGGGCUCCAGGUGGCAAAGGUGCACACUUCCUCAGACACAGGU	UGCCUUGGUGAUCACUGAAC	-14.80
UCUCCUUCGACAGGGGACGUAGCCUUUUCUUGCUCUGGAAGCCCAGGGAG	UUUUCGUUGACUCCAAGAAC	-22.60
CCCUCCUCGGCUUCCUUCCUCUCUGCAAUGACCUUCAACAACCGGCCACC	UGGUAUCCCAUUUUGGUGAC	-9.30
UUUUGUGCAAUUGUUUCUCACCCUGCUGAUUCUGUGGUAUCUGUGUUGAA	ACUCAAGAUGGUAACGGUUU	-10.40
GAAAAACAGACCGGGAAGAGAAGACCUAGGAGCAGACGCCGGGAUCCAGG	GUCUCGUCUGCACCAAGAGU	-21.90
ACAACCGCUGGGAUGCAUCUGCCUCAGAGCCCGAGUACAUGGAGGAGGUG	GAUAUGUUAGAUGAUGGAGU	-16.10
CAGUCCUCCAAGAAAGUUGCUUUCCUCAGGCAGAAUGCCCCUCCCAAGGG	GAAGACUGAGGUUCAGGUCA	-18.20
GGCCGGGUGCAGUGGCUCACUCCUGUAAUCCCAGCACUUUGGGAGGCCGA	GGGUACCUUAAGUCAAGAGU	-20.10
CCCCUCAGCCCCCACCCACCGGCCAGUCGGACUACACUAAGGCCUGGGAA	UCUGCACCUCUUUAAUCUUA	-12.60
AAGCCGCCAAGACCCAGCUGGCUGUGUGCCAGCAGCGGAUCCGAAGGCAG	CUCUCCUCACGUUGAUCGUU	-21.70
AGAAUUCGGAAGAAGCCGGGACCCAAGCCCGGAUGGAAGAAGAAGCUUCG	UUCGUCGUGUCAUUAUAACC	-13.60
GCUUAGUUUCCCGUCAUGGUCUCAUUCCCCUGGUGAAUUCGAUGGAUGUG	GUUUGGUGUCACACGACGAC	-10.60
CUUGACUACCGGGAGCAGGCUCAGCAGAUAGAAUUGAAGACCGGAGGGAU	CAGAGUGAAACAACGGGUCU	-11.10
CCAACGGCGAGGAAGUGGCAGUGAAGCUAGAAUCUCAGAAGGCCAGGCAU	GAUUCUGUGUCCGGGUCUCU	-23.00
ACUGUUCCUGUUGGCCGAGUGGAGACUGGUGUUCUCAAACCCGGUAUGGU	CUUCCUCGUGAAUCCCGUCA	-16.20
UCAUCUGCACUGCCAAGACUGAGUGGUUGGAUGGCAAGCAUGUGGUGUUU	ACCCACACACGUACUCGCAC	-21.50
CAGUACCUAUAGCCAAGCUGCAGCGCAGCAGGGCUACAGUGCUUACACCG	GUUAUCUGACACUCGAGGAA	-21.80
UUCAAACGGGGGCACGGGCCAGCCCGAGGGUGGGCAGCAGCCCCCUGCUG	CGUUACGUUGUCGUUACGUG	-31.00
CACAAGCUCGCCUGACCCAGAUGGUAUUGGACACAGUGCCCCGCUGAACA	GAGAAUGAGGGAGUCCGUGA	-20.10
UCUGGCUCCACUCAGUGUCUAAGGCACCCUGCUUCCUUUGCUUGCAUCCC	CUUCACCCGGCCCGUGUCCC	-13.20
GAUUCGGAAAUUUGCCAUGAAGGAGAUGGGAACUCCAGAUGUGCGCAUUG	CAGUGACUUCCCAAAACUCA	-12.90
AAACAUAAUGAUUAAUGUUCCAAUUAUGCAUCACUUCCCCCAGUAUAAAU	UCCGGCCCUGUUCACGUUAU	-5.60
GCCCUCUCAACAUCAAUGGUGCUAGUUAUCUGCGGCUGCCCUGGGUCAAU	CUCCCCGGAGUCUGGCUCGA	-15.10
UCGUGAGAAGUACCCACAUGUGCAGAUGAACCCACACCCAGUACCAGAGC	GGAAGAGUUGGGUCGAAA	-15.60
AAAACCAGCUGGUGGGCCCAAGCCUCCAAGUGGGAAGAAAGACUGGGAUG	CGUUACGUUGAUGUUACGUG	-21.30
GUGUUAGUGUCGGGGAAAUAGUUUGCAGAUAAUGGAGGAGUAACCCUACA	GGAGCCGCUAGGGGCGCCGA	-14.20
UGAUGCUGACGUCCUGAUUGUCUAUGCCAAGACAGAUCUGGCUGCUGUGC	UUUCUGUCAUCUAACAUAUC	-14.20
CCGUGGGCACCUGGCAAAGAUCUAUGCCAUGCACUGGGGGACCGACUCAA	GACGUCCGGCACACGAAACG	-22.60
CCAACGAUGGCCUCAAGUUCUCCCAGGAGUAUGAGUCCAUCGACCCUGGA	UAGGGUAGGGGUCCUUGGGG	-26.70
UGGUGAAUAUAGUGCUGCUAUGUUGACAUUAUUCUUCCUAGAGAAGAUUA	GUACCGGUUUUGUCUCUUCU	-20.40
UCACUAUCUCUGCUCUGUGCUCCUCAAAAUAUAAUUUCAAAUGGAUCCGA	CGGUUCAUUACCUCUUGUCC	-7.50
ACCAUGAAGGAGAAGUAAACAGGGCCCGUUAUAUGCCCCAGAACCCUUGU	UCUGCACCUCUUUAAUCUUA	-16.40
GGCCAGCAGCCCCAUCCCGGUGGUGAUCAGCCAGUCGGAAAUUGGGGAUG	GGAAGAGUUGGGUCGAAA	-27.60
UCAUCAGCCGGGAGAGCAGCCUCAUUCUGGCUGUCACGCCCGCCAACAUG	UUGUAGUCAGACUAUUCGAU	-24.10
UUGGUGGAAGGGCUGGUUCUCACCCAAAAAGUGUCAAAUUCUGGCAUAAC	CAAAACGUAUCUAAACGUGU	-14.00
AAGGGUGCUUAAUUCUGUUGAAACCAAAAAGAUUUGUCUACAAAUGCUAU	CCAGGGAGCCCGGUCCCGUC	-12.50
UGGGACUGGAGCCUGGGGAAAACUUCUGUAUGGGAGGACCUGGCAUGAUC	AUCUCACGUCUGGUCCCAGA	-20.00
AGAUUCCAAAUGCGGCCGGGCGUGGUGGCUCACGCCUGUAAUCCCAGCAC	GACCCCUUUUCCCACCGUGC	-19.40
UCGUGCCAAGGAACGGAGAGAUGGAGUGAACAAAGAUUAUGAAGAAACCG	UAGGGACCCUGGUAUGGAUC	-11.40
UCUCACCCCUUCUUUCCCAGGGAUACUGAGGAAUGGCUUGUUUUCUUAGA	AGACGUGAUCUACGUGGAAU	-15.60
CAUGAGAACCGUCCCCUGGACCUGCUACACAAGAUGGAGUCAAAGAGCUC	GUGUCGGGGGCAGGGAGGGA	-25.00
CCCACCCCUGAAGAUCCCAGGUGGGCGAGGGAAUAGUCAGAGGGAUCACA	UGGGGACCUCUAAGACUAUU	-24.70
ACCAACCUGGUGCCCUACCCCCGCAUCCACUUCCCUCUGGCCACAUAUGC	GUUUUUUAAGUGGAAACCCG	-13.30
UACAGUGGUGCAGGAGGUGAUUGAAUUCUUUGUGAUGGUCUUCCAAUUUG	UCUCUGUUAUAACUAUCCCA	-10.80
CACGUGCAGGCGUCGGUCCGGGCCACUCCAGUGACGAGGGUAGGAUCCGC	UAGGGUAGGGGUCCUUGGGG	-21.90
CACCUGCUGCCCCUUCUACCCCAGCUCCACCACCUGCAGUCCCUAAAGAA	UAGUCGUACGGUCCUUGGGU	-13.90
GACAAGGAGACAGAGGAGCUGGUAGCCAGCCGCCAGAUGAGCUUCCUAAA	ACCUCCUGCCGUUGUCAGUC	-19.70
UCGAUCACCAGCACCAGGGUGGCCCGUGUGCGUGGGGCCAGCGUCGCCGG	ACCCUCCCGUCACCACUCUC	-19.80
UUUGAUGAGCGAGAUGGUGCUGUCAAGGCUAUGGAAGAAAUGAAUGGCAA	CUCCGGGGACGGCGGGGC	-17.60
UCCUGAGGCCUGGGGCACCUUUCGUCUGAUGAGCCUCUGCAUGGAGAGAG	ACAGAGGUGUCCCGAGAAAU	-17.80
GAAUCUCAGGUGCCAAGGGCCAAUCUAUGGAAUGACCUUUGCUCUAAUGA	GUUUUUUAAGUGGAAACCCG	-14.20
UAUCAGAAAUACAUGAAGCCCAAGGAUACGUCUAUGGGCAAUGCCUCUUC	UCAUUUGUUGGGAGAGGGUC	-21.20
GCCCUGGAUUAUACAUACUGUCCAAUUUUCAUUAAAUUUUUGUCUUAUAA	UGUUGGGAUCACCGCGGUAA	-11.80
UCCCAGCACGCCGGGAGGGGCAACCAGGCCUCCCAGCGAGUCCUGCAGGG	UAAUCCUUGUGUAGCGUUUU	-22.20
AGUUCCAGGACAUGUGUGCAACCAUUGGCGUGGAUCCGCUGGCCUCUGGA	UAGUAAUGGUCCGUCAUAAU	-22.00
ACAUUUAUUUCCAGUCCAAAAUGGAGCUUUAUAUUGUGUUUGUCAUAAAU	UUAGGAACGGGCCCACGUAA	-11.30
UACCAACAGUAACCAACCUCAGUGUGGGUAUAAGAAACCACCUAUGACCU	ACUUUGGUUCAUACCCAGCG	-18.40
UCAGUCGGGUCCCGGCAGCGGCUGCAGCGCUCUCGUCUUCUGCGGCUCUC	GUUCGGGUCUGGCGUUUUUC	-27.20
CUGUCUUCCCCCACCUGCCUAGCCCAUCAUCUAUCUAACCGGUCCUUGAU	UGUGGGUGCGCUCGGCCUUU	-18.20
CUACACCUCAGCCCGGGGCUGCACUGCCACCCUGGGCAACUUCGCCAAGG	CACUCGUGGGCCGGGGACGC	-28.30
AAAUUUGAGCUGACCAUGCCCUGCUCCUCCCUAGAAAUCAAUGUUGGACC	AGGGGAUCUUAGCUUAGACA	-19.40
AUCUCAAACUCCUGACCUCAGGUGGUGAUCUGCCCACCUCGGCCUCCCAA	GUGGGUCUAGACGCCGGAUU	-26.00
GUCAGGGCCUACAGCGACCAGGCAAUUGUCAACCUCCUCAAGAUGCGGCA	GUGGCUGUCGUUACUUACAA	-16.00
GACUUUGCCGAGAAGGAGUUGUUUCCCAUUGCAGCCCAGGUGGAUAAGGA	CCGUUAUACAACCGUAUCGU	-13.60
CGCGCUGGAAGUCUCCGGGGGAGUCGCUGUUGCUGAGGCUGUCGCCUGAG	GACGUCCGGCACACGAAACG	-24.40
AGCUCUUGGACGUGCUGCUGACAAUAGUGGCCCUCGCAGGUGCUACCGGC	CUUCCUCGUGAAUCCCGUCA	-19.50
AAGCUGAAAAAAGUUUUGCAGGAAGCCUCCAGUCCUGUCCCACAAGAAAC	ACUUAAGAUGGUCACGGUAU	-15.30
AAACACCUGUAUGGCUGCCAUUCUCUUCAGCCCUCGCUCUCCCCUUUCCA	ACGUGGUCGGACGGACGACU	-18.90
UCCAAUAUUUGUUUGCACUAUGGCCUACCCCACUGUGCCUUGCCCUCUCC	CCGUAAGUGGCGCACGGAAU	-18.00
CUACACCUCAGCCCGGGGCUGCACUGCCACCCUGGGCAACUUCGCCAAGG	GGGUCUCGGAGUCGAGGGGU	-30.40
CCUCCUGCUGAACUUGAAGAGAGACCGUGUAGAGAGUAGAGCUGGAUUUA	CACGGACUCCCUCAUUCUGU	-14.00
AGCUGAUGCGGGUCUACGGGGCCCUCAUGUGGUCCCUAGGCAAGGUCAUC	UGACUAAAGUUUACCACGAU	-24.20
GUAGAGAAAGCAACUGCUACGAUCCUGAGCGAGUCAAGAAUUUUCUUAAG	UGUUGGGAUCACCGCGGUAA	-16.40
CUAAUUGAUGAGAGGCUCGCUGCUUGAUGGUGUGUACAAACUCACCUGAA	GCCCCGUCGAGUCAUGUCCU	-16.90
AGACUGGAGUGCAGUGGCAUGAUCUCGGCUCACUACAACCUCCACCUCCU	UUAGGAACGGGCCCACGUAA	-18.20
GCAACUACCUGCUUUUAAUGACUCACUUUGAUCAAAUGACAGUGAACAAA	AGGGUCACGCCCUGGGGAGG	-13.30
AAAUGGAAGGCCACAGAAAAGGGGAAAAGAGGAAAUAAUACAGUAAUCGU	CGACAGUUAAGUAUCCAGUC	-4.80
AAGGCGAGACAGGCUCAGGGAAGACCACCCAGAUCCCGCAGUAUCUCUUU	CCUCUCUGUUCCCCUUCUCC	-24.50
UUUAAGACAGGGAAAGGGAUCAGUAGGCGGAUUGGAAGAAAUUUCAAGUC	AGGGGUGUCUGGGUCUCGGC	-14.30
CCCAACAGAACCAGACGCAGACUCACCAUACCACGCAGCAGACAUUCCUG	GGUCUCCUUUCGGUCGGGGA	-11.20
GAGGCGGCCCCUCCCACGGCUCCCAAUAAAAAUGUGAAAACCAACCCCCG	CCAGGGAGCCCGGUCCCGUC	-19.00
CCUUGAUCAGUGCUGCUUUGUUGUGAGAAGUUUUACUUUGUUCUGCUUCA	AACUGUUAUAGUAACGUGAC	-12.10
CUAUCUACUCAGCCUUAUGAAUGCCCCUCGCUUUUCUAAGGCCAUGUGAA	AGUCUUAGUGUGGACCCCCU	-15.00
GUGGAGGCCGGAGCAGGAACAGGUUGAACAGUCUACCCUCCCUUAGCAGG	UCAAGAAGUUGACCGUCGAA	-15.20
ACAUGGCUGAGCUGGGCAUGUGCUGAGGUUGACUUAGGGAACAAGCCCUG	UGUUGGGAUCACCGCGGUAA	-22.00
CAGAGAGAGUUCAACAGCAGGCCAGGUACAGGAUACGUACCUGUGGAGUU	CGCCUGUGCUGUAAGGGCUA	-14.20
CUGAGGCCAAGAAGGAGGAGACCUGGAAGCUGAUGGAGGCUGACAAGGCG	GUUUUGUACUUAACGACGAC	-14.80
CUAUCGGGGUCACAGGGACGCUAAGAUUGCUACCUGGACUUUCGUUGACC	ACUUUGGUUCAUACCCAGCG	-18.10
CAGGGCCAGUGCAUAUUAGUGGACAGCACUUAGUAGCUGUGGAGGAAGAU	UCCAUGGUUAUAAAAUAGAU	-16.40
CGCCCGCCCGGAGCCCCGCGUCCCUAGGCCUGGCUCCCGCCUGCCCGAGA	ACUUAAGAUGGUCACGGUAU	-22.70
AAUUGAAGAAAGAGGAGAAAAGUCUUAGAGUGUGGAAAAGGCAACCAGGU	GUCCGAGGUCGAAGGUCCGA	-17.90
GCUGUUGCAGCAUCCAGUUCAUCUUAAGAAUGUCAACGAUUAGUCAUGCA	CCGACGUUGUGUUCUGUGCU	-15.70
GGCUGCAAAGUUGGCCGAGGCACUUAUGGUCACGUCUACAAAGCCAAGAG	GAUAUUCGUUAUAACGUGAU	-14.10
AUUCGGCCCGACGAGCUCCGCUUUCGCUACAGCAUGGUGGCCUACUGGAG	GGACUAAGUGUUGUGGUCGA	-17.60
GCUGGUGAAGCGGGUCCGGGAUCUCUACCACAAGCGACUGCCAGACGUCC	GAGCUUGGUGACUAGGUCGU	-18.80
GUGCCAGAGUCAAGGGCACCUGGGGAAUCUGGGCCUCAACUAGCUCGUCC	GUACACGUGUGUCGGCCCAC	-25.00
CACGCUCUGUCUCUAUCCCAGCACCUGCCUACUAUGCCCGCCUGGUGGCU	CCUCUCUGUUCCCCUUCUCC	-7.20
UAAUCUGUACCUGGGUGUGGUGCUAUCAGCCGUUGUAAUCAUAACUGGUU	GACCCCUUUUCCCACCGUGC	-20.50
CCUGAGGAGACCAAGCUGGGCAAGAGGCAGUGCGACGGCAAGAAUGCGCU	UCAGGUUUCCCUUCGUGAAA	-20.20
UCUCCCCAGAGAGCUUGACCAAGUUACAUAUUCUAGAGAUCGUCCUGAGU	CUCGAGGACCUCCUGUCCCU	-12.70
UGAGGCCAGGGCCAGGGCCAGGGGACUCUGUGAGUCUGGCUCAAGACCGA	CUGAUAUCUUGAAAGGGGGA	-20.80
AACAGCCCACCACAGAGGCAGAUGCCAAACCAAAGACAGAUUGCUUAACC	GUCUCUCAGUCUCGCGCCUA	-14.30
GGGAACACCAUGAACCAGGGCAUGAAACUGAAAGUGCAUAACAUAUUCUA	CGCCUGUGCUGUAAGGGCUA	-17.10
GGAGCCCCAGGACCUGCCGGACCCCCUGGAGACCCGGGGCUGAUGGGUGA	AAUUCACGAGUAUUACGUCA	-25.80
CUUUGAGAAUCUCUUCUCAUCCACCCUCUGGCACCCAGCCUCUGAGGGAA	CCCCCGCCGUGUCCCCGAGU	-18.80
AUAUGGAGAGCGGAAUCUGGAUAGAUGGCGGGAUAAGCAUGUGGACCGCC	UGUAUGAAGAAAUGUAAGGU	-11.60
UUCGACCUCGUGCUGCAUAAAUACUUACAGGCGGAAGAGUACUCAAUCCG	CUUUGGUCGUUCACAACUGC	-8.50
UAUGUGAGAUUGAUGCUACGGGUCUUACGGACUCACACCCGUUCCCACUC	GACAUGUUUGAUGAUGGAGU	-16.30
AAGGGGAGAGGAUGGUAGUGUCUGACUUCCACGUUUUCGUCAGGGAUGUG	CGCCUGUGCUGUAAGGGCUA	-17.80
AAACGGUGCCCAAGCCCUGCUGUGCGCCCACGCAGCUCAAUGCCAUCUCC	AUGGACUUAAGGGUUUUCGA	-17.00
GUUUGAUGAAGGCCGGAACAACUUUGAAGGGGAGGUCACCAAGGAGAACC	UUUCGAUCCUCCGGCAUAUC	-16.00
AACCACGUCUCCUACUUUCCAAACCCAUGGCAGUGUCCCUGCUCCAGACU	UAGUUAUGAAGGACCGAGGG	-16.60
CAAACUAUUGGGAGGGAUGAGAGUGGCUUAAAAACUUCCAUCCCUACUUU	GAAUAGUCCAACAUAAUAUU	-20.70
CUCUCCAGCACCAGCUUCCAGUUAGUGGAUAUAGCACACCAUCCCCAGCC	UAGUUAUGAAGGACCGAGGG	-14.60
UGGUGCUAAUAACGCCAAGGUCGCGGGUUCGAACCCCGUACGGGCCAGUG	GGGGUGACCCGGCAUGGGUG	-25.10
ACUCCAGCCUAGCCCCUACCCCCCAAUUAGGAGGGCACUGGCCCCCAACA	GCCCUCCCCUGACUCGGACU	-23.70
CUUUCUCUCUGGCCUGCUGCUCUCUCAACAUCACAUACAGCUUCAGCUGC	UCUCGGAGGUGGGUUGGGAG	-22.00
ACGAGGGCCGUGAGGGCAUGACCUGCUACUACCUGACACACGGUUGGGCG	CGGGAAAGUAGUAACGUGAC	-16.50
AUAAGCCCAAUCUCUCACCUGCAGUUAAGAAUCAUCAUUUUCUGUGACUG	UAGGGACCCUGGUAUGGAUC	-16.30
CUCUGACUAGCUAAACUGCCAACUAGAAGAAUGGUUGUUAUGUAGUAACU	CCCCCGCCGUGUCCCCGAGU	-11.80
AGAACUUCAGGCUCCUGGGCAACGUGCUGGUCUGUGUGCUGGCCCAUCAC	GGGUUAAUUACAGACAACUA	-14.30
GCCUAGCUGGAUUGCAGAGUUAAGUUUAUGAUUAUGAAAUAAAAACUAAG	CCGUCCGUACGCCCGUCUGU	-11.40
CUAUUACACAGCCCAGGGGGAGCCGUUCCCCAACAACCUGGACAAGCUAU	AGCCUCACAGAGUCUUGAAA	-13.70
GUUCUAUGGGUCUCUUGCUAGGGGGUAAGGAUUUUUAUUCUUGGGCUUAU	GUUCACUUCGGACCCCCGAU	-19.40
AAAACAAGAGAAGCCAUUGCCAUGCUACACAAAGAUGGCAUAGAAUUUGC	CUCCCUCUGGGUCCGAGCCU	-15.70
ACAUUUUUGCCUGGGGCAAUGGUGGUAAUGGCCGCCUGGCAAUGACCCCC	GACCAUGUUCCCAACCCUCU	-20.40
UUCGAACUCUGGAGCUGCUGCUUAUCUGUGCAGGCCAUCCUCAAUAUGAG	UGACGUGAUCUACGUGGAAU	-15.30
CAGGUCUAACCACAGAGCCGGAAUAAUUAAUACCGUAUUAUAUACCCCUU	GUUUCUGGCGUUAAUGAAAA	-12.90
AACCACGUCUCCUACUUUCCAAACCCAUGGCAGUGUCCCUGCUCCAGACU	CUCUCCUCACGUUGAUCGUU	-11.00
CUACCAGGAGUACUCGGCCACCAGCCACGAUGGUACCUCCAACUUCGGGC	UGUGGAUCCAAGGUUCCUAA	-16.60
UACAAUGGGCAGAGUGUGGAGGUGGACGGGCACUCGAUGCGGAAGCUGAU	CUUCCGUUAUCUAACAUAUC	-16.60
GAAGCUUUGGAACUCUUGGGUGCCUCCUUUGCAAAUGACCGUGAGAACUA	UUCCGGUGUAGGUCGUGGCA	-15.40
CCCGACCCAGGGCGACAGGCUCAGGCCAAGCUGCCCGUGGUGGGAGGGCG	CAAGAGGGUUGCAUUUGGGU	-26.70
CUGUUUCUUGCACUGAAUAUAUAAACACUCCACAGUGUUUAUAUUGGGAA	GUUCAAGACAGUACGUGACU	-27.40
UCUUGCCCUUCAUUAUUGCAGCCCUAGCAACACUCCACCUCCUAUUCUUG	UUUCAAGACACUACGUGACU	-5.50
UCUUCAACCAACACCAAAACAACCUCAGGUGACCCCCAUGCCUCAACAGU	CACGUUUUCAUUGACAUCGA	-6.70
UUGGUGGGGAACAGAGCCCCUGUAGCCAUUGGAGUUGCAGCCAUGUCCAC	GGACUAAGUGUUGUGGUCGA	-18.50
GGUGGGGACAGAGGAGGCGGCUAUGGAGGAGACCGAGGAGGUGGCUAUGG	GUUCGGAACCCACACCCUCC	-21.00
GUUGAGGAGGAGGCCGUGACCCUAGCCCGGGCUGAGACCACCCAAGCCAG	UCUUCCGUGGUACCCUAAAU	-22.50
AAAUGCCACAGCUGGGGCUGAGCUGUAUUCCUGUGGAGGGACCUCUGCCG	GUGGGUCCAUCGUUCCUAAU	-20.40
UUAGAGGGAGGCAGAGAGGGAUCGUUCUUCGCUUUUCCUCCGGUGCCUGA	AAUUCACGAGUAUUACGUCA	-21.50
AUUUCCAGGACUGCCCUCUCCAGAAAAACAGUAGCAGUUUCCUGGUCCUG	GGGUUCUCGGACUGAACACU	-17.00
AGUGAUGACCGGGACGAGUCUGAGAACGAUGACGAGGACACAGCCCUGUC	GCACUGUACUACUAGGGGCU	-20.10
CACUUUGCCUUGGGCAGCUGCACCAAAUUAGAAUUUCCAGAUGUGACUCA	GCGAUCGUUAUGUGACGGAU	-13.50
GGCCGCGGUAAGGGCGGAAAGGGUCUAGGUAAGGGUGGCGCCAAGCGUCA	GUGGCUGUCGUUACUUACAA	-21.40
UUUAUUUUCACAGAUUGGGGUAACGUGCACUGUAAGACGUAUGUAACAUG	GCUUCGAGGUUCCAAGGAGG	-8.80
UUGUGGAAUUAUUUCGUGGGAAAAUAAAUUUUUAUAACUUCUCCCACUUC	UUCUUCCCCCCCUUCCCGCA	-11.60
UGCCUCUCCUGCUGCCAUCCGUUUCCCUCAUAUAUUUUGGACAAGAUUUA	UAACGUUGGCUAGGGUUGGA	-14.90
AUGUUUCAUUUAGUAUCCAGGGGUCUGUCUGGAGACUUCUAGAGAGGGAC	ACAUUUGUAGGCUGACUUUC	-17.20
AUAAAUGUUUUGGAAUUCAAUGGGUAAAUAAAUGCUGCUUUGGGGAUAUU	GAAUAGUCCAACAUAAUAUU	-5.40
AACCAAAAAGCUGCUGGAUAACAUUUGUCAUUCAUAUUCUUUGCAAGCAU	CGUGAAAAUACUUAUUCGAG	-8.10
GACCCUGCCAAAUCCCCCUCUGUGAGAAACACCCAAGAAUGAUCAAUAAA	GGAUAGGACCUAAUGAACUU	-7.10
GAAGCCCUGCCCAAGAAGAGCCAACAGACUUCCUGAGCCGCCUUCGAAGA	UGAGGGUCCCACAUUGAGAU	-13.80
UAAUACUUGCCUACCUACCUCACAGGGGUGUUGUGAGGAUUCAUUUGUGA	CGUCGUCGCCUCCCCCGUCU	-14.30
GAGGACCCAGCUGUGGAUGUGAUCAGGAAGCUCCUGCAACUUCCCAACAC	ACCUCCUGCCGUUGUCAGUC	-24.00
AAUGACUUUGAAGGGCCCUAAUGACUUCAAGCUGGAGGACUUCUACUCUG	GUUGUUGUACUUUGAUGGAU	-14.60
ACUCCAUGGGGUGCCCAGACCACUUGCUAUGAAAAAAGAGGGAAUUCAAA	CGGAGUCAAAGGUGUGGACU	-15.90
UCCACUAGAAGGCUGGGACAGCACCGGUGAUUACUGUCUUUCCUGCCUCU	UUUAAGCCAAGAUGUCCCAU	-14.30
ACAGAGCGGGGCGUAUGCUACGACUACAACUUUUAUAGCUGUUUUGGUAA	GUCCGUCAAAGAACAACGGC	-13.80
AGUAGUGAGGGCCAGUCGAGCCUGUCCAGCCUGGAGAAACUGAUGAUGGA	CUUUAGGGACCGUUACACUA	-15.60
UCUAUUUUAUGUGCUCUAUGUUCCCAUUUGUUUGUUUGGUCUGGACAGUG	UGCCCUCACUAGCACAGUAA	-8.30
CACCCUUGAGGGCCAUGAAUCCACUGUGUGGAGCUUGGCCUUUGACCCGA	AUCUCACGUCUGGUCCCAGA	-24.50
GAAGGUUCGGAUCCGGGAUGCCUUGCGCAGUAUCCUCACCAUAUCUCGAC	UUCCGGUGUAGGUCGUGGCA	-23.70
AGGAGGUGGAGACUUUUGCCUUUCAGGCAGAAAUUGCCCAACUCAUGUCC	AGUGGCUGUCCAACUUACAA	-18.90
GAUUAUCUAAGCUUCCAGGUUUUAUAAUUAGAAGAUAAUGAGAGAAUUAA	GUCUCGUCUGCACCAAGAGU	-9.40
AUCAAGACUGGAGACAAAGUGGGAGCCAGCGAAGCCACGCUGCUGAACAU	GAGUUCCUCGAAGUCAGAUC	-17.60
AUAAGAAGAGAAAGGGCCAAGUGAUCCAGUUCUAAGUGUCAUCUUUUAUU	UGGGAGAGUUGGGUCGAAAA	-14.50
AGAGGGAGGAGGAGGAGCAGCUGAAGAGAGAGAGCCCCAGCCCCAAGGAG	ACUCCGACACCCCGACCUCA	-19.40
CUUCUUCACUGACUCUUGUCCAGAUGCCCUGUUUAAUGAACUGGUAAAAU	GGGGGUGGUGGUGCGGGC	-20.70
UGCUCCAGAAACUGCCAGUGCCCCUCUCUCAAUGGAUGACCCAUCUCCCU	UCAGGUUUCCCUUCGUGAAA	-10.30
UGACAGUGCCACAUACUGCGGACCAAGGGACUCCAAUCUGGUAAUGGUGU	CGGUUCAUUACCUCUUGUCC	-14.90
GCACCUGAAGAAACCUGGGGGCUUUGACAUAUCCUUGUUCUACAGAGAUA	GCCCUCCCCUGACUCGGACU	-16.00
UAAAGGCCUGGGGUGUGUGGCCUAAAGCCCAAGAGCGGUGGGGCGACCCU	GUUGUUGUCCUUUGAUGGAU	-25.40
